SCH_YEAR,CNTYNO,CNTYNAME,DIST_NUMBER,DIST_NAME,SCH_NUMBER,SCH_NAME,STATE_SCH_ID,NCESID,COOP,COOP_CODE,WHITE_MALE_COUNT,WHITE_FEMALE_COUNT,WHITE_TOTAL,BLACK_MALE_COUNT,BLACK_FEMALE_COUNT,BLACK_TOTAL,HISPANIC_MALE_COUNT,HISPANIC_FEMALE_COUNT,HISPANIC_TOTAL,ASIAN_MALE_COUNT,ASIAN_FEMALE_COUNT,ASIAN_TOTAL,AIAN_COUNT,AIAN_FEMALE_COUNT,AIAN_TOTAL,HAWAIIAN_MALE_COUNT,HAWAIIAN_FEMALE_COUNT,HAWAIIAN_TOTAL_COUNT,TWOORMORE_MALE_COUNT,TWOORMORE_FEMALE_COUNT,TWOORMORE_TOTAL,MALE_TOTAL,FEMALE_TOTAL,MEMBERSHIP_TOTAL
20172018,1,ADAIR,1,Adair County,16,Adair County Elementary School,1001016,210003002021,GRREC,902,272,285,557,5,4,9,21,13,34,1,1,2,0,0,0,0,0,0,18,16,34,317,319,636
20172018,1,ADAIR,1,Adair County,10,Adair County High School,1001010,210003000001,GRREC,902,375,361,736,10,5,15,21,10,31,1,0,1,0,0,0,0,0,0,15,11,26,422,387,809
20172018,1,ADAIR,1,Adair County,14,Adair County Middle School,1001014,210003001919,GRREC,902,280,237,517,5,7,12,16,16,32,2,0,2,0,0,0,0,0,0,8,6,14,311,266,577
20172018,1,ADAIR,1,Adair County,20,Adair County Primary Center,1001020,210003002345,GRREC,902,258,218,476,5,2,7,12,16,28,0,1,1,0,0,0,0,0,0,12,11,23,287,248,535
20172018,1,ADAIR,1,Adair County,12,Adair Learning Academy,1001012,210003001913,GRREC,902,15,2,17,14,0,14,1,0,1,0,0,0,0,0,0,0,0,0,3,0,3,33,2,35
20172018,1,ADAIR,1,Adair County,,---District Total---,,,GRREC,902,1200,1103,2303,39,18,57,71,55,126,4,2,6,0,0,0,0,0,0,56,44,100,1370,1222,2592
20172018,2,ALLEN,5,Allen County,901,Allen County Career and Technical Center,2005901,210007002061,GRREC,902,0,0,0,0,0,0,0,0,0,0,0,0,0,0,0,0,0,0,0,0,0,0,0,0
20172018,2,ALLEN,5,Allen County,60,Allen County Intermediate Center,2005060,210007000013,GRREC,902,323,352,675,2,1,3,17,16,33,1,4,5,1,0,1,0,0,0,4,2,6,348,375,723
20172018,2,ALLEN,5,Allen County,10,Allen County Primary Center,2005010,210007000008,GRREC,902,421,399,820,2,6,8,17,20,37,4,3,7,0,0,0,0,0,0,22,8,30,466,436,902
20172018,2,ALLEN,5,Allen County,20,Allen County-Scottsville High School,2005020,210007000010,GRREC,902,423,427,850,3,5,8,21,11,32,1,2,3,0,0,0,0,0,0,4,6,10,452,451,903
20172018,2,ALLEN,5,Allen County,15,James E Bazzell Middle School,2005015,210007000009,GRREC,902,209,184,393,1,4,5,6,3,9,1,0,1,0,0,0,1,0,1,7,10,17,225,201,426
20172018,2,ALLEN,5,Allen County,,---District Total---,,,GRREC,902,1376,1362,2738,8,16,24,61,50,111,7,9,16,1,0,1,1,0,1,37,26,63,1491,1463,2954
20172018,56,JEFFERSON,6,Anchorage Independent,10,Anchorage Independent Public School,56006010,210009000014,OVEC,906,183,148,331,3,1,4,6,4,10,11,12,23,0,0,0,0,0,0,5,6,11,208,171,379
20172018,56,JEFFERSON,6,Anchorage Independent,,---District Total---,,,OVEC,906,183,148,331,3,1,4,6,4,10,11,12,23,0,0,0,0,0,0,5,6,11,208,171,379
20172018,3,ANDERSON,11,Anderson County,30,APEX Academy,3011030,210012002371,CKEC,901,17,5,22,0,1,1,1,3,4,0,0,0,0,0,0,0,0,0,0,2,2,18,11,29
20172018,3,ANDERSON,11,Anderson County,20,Anderson County High School,3011020,210012000016,CKEC,901,470,468,938,6,8,14,13,19,32,2,9,11,2,0,2,0,0,0,21,21,42,514,525,1039
20172018,3,ANDERSON,11,Anderson County,25,Anderson County Middle School,3011025,210012000017,CKEC,901,405,395,800,8,8,16,19,10,29,1,3,4,0,1,1,0,0,0,14,17,31,447,434,881
20172018,3,ANDERSON,11,Anderson County,110,Emma B. Ward Elementary School,3011110,210012000021,CKEC,901,235,197,432,3,4,7,2,5,7,4,3,7,0,0,0,0,0,0,7,10,17,251,219,470
20172018,3,ANDERSON,11,Anderson County,120,Ezra Sparrow Early Childhood Center,3011120,210012001298,CKEC,901,73,62,135,2,0,2,4,3,7,1,1,2,0,0,0,0,0,0,0,4,4,80,70,150
20172018,3,ANDERSON,11,Anderson County,22,Robert B. Turner Elementary School,3011022,210012001955,CKEC,901,257,220,477,1,2,3,9,6,15,3,1,4,0,0,0,0,0,0,12,15,27,282,244,526
20172018,3,ANDERSON,11,Anderson County,50,Saffell Street Elementary School,3011050,210012000018,CKEC,901,190,192,382,4,6,10,20,10,30,0,0,0,0,0,0,0,0,0,16,9,25,230,217,447
20172018,3,ANDERSON,11,Anderson County,,---District Total---,,,CKEC,901,1647,1539,3186,24,29,53,68,56,124,11,17,28,2,1,3,0,0,0,70,78,148,1822,1720,3542
20172018,10,BOYD,12,Ashland Independent,50,Ashland Middle School,10012050,210015000023,KEDC,903,346,331,677,20,14,34,17,9,26,2,5,7,0,0,0,0,0,0,22,19,41,407,378,785
20172018,10,BOYD,12,Ashland Independent,130,Charles Russell Elementary School,10012130,210015000031,KEDC,903,108,117,225,4,9,13,2,2,4,1,1,2,0,1,1,0,0,0,6,12,18,121,142,263
20172018,10,BOYD,12,Ashland Independent,70,Crabbe Elementary School,10012070,210015000025,KEDC,903,111,109,220,8,9,17,8,7,15,0,0,0,0,0,0,0,0,0,13,11,24,140,136,276
20172018,10,BOYD,12,Ashland Independent,80,Hager Elementary School,10012080,210015000026,KEDC,903,151,158,309,2,2,4,7,9,16,3,3,6,0,1,1,1,0,1,9,7,16,173,180,353
20172018,10,BOYD,12,Ashland Independent,100,Oakview Elementary School,10012100,210015000028,KEDC,903,153,133,286,9,4,13,4,3,7,0,0,0,0,0,0,0,0,0,2,10,12,168,150,318
20172018,10,BOYD,12,Ashland Independent,10,Paul G. Blazer High School,10012010,210015000022,KEDC,903,398,384,782,14,14,28,12,8,20,2,2,4,1,0,1,0,1,1,14,19,33,441,428,869
20172018,10,BOYD,12,Ashland Independent,110,Poage Elementary School,10012110,210015000029,KEDC,903,122,103,225,8,7,15,2,4,6,1,1,2,0,0,0,0,0,0,6,5,11,139,120,259
20172018,10,BOYD,12,Ashland Independent,,---District Total---,,,KEDC,903,1389,1335,2724,65,59,124,52,42,94,9,12,21,1,2,3,1,1,2,72,83,155,1589,1534,3123
20172018,12,BRACKEN,13,Augusta Independent,11,Augusta Independent School,12013011,210018001968,KEDC,903,148,130,278,4,2,6,1,0,1,0,0,0,0,0,0,0,0,0,1,0,1,154,132,286
20172018,12,BRACKEN,13,Augusta Independent,,---District Total---,,,KEDC,903,148,130,278,4,2,6,1,0,1,0,0,0,0,0,0,0,0,0,1,0,1,154,132,286
20172018,4,BALLARD,15,Ballard County,905,Ballard County Career and Technology Ctr,4015905,210021002404,WKEC,908,0,0,0,0,0,0,0,0,0,0,0,0,0,0,0,0,0,0,0,0,0,0,0,0
20172018,4,BALLARD,15,Ballard County,50,Ballard County Elementary School,4015050,210021000356,WKEC,908,251,229,480,5,4,9,6,6,12,0,1,1,0,0,0,0,0,0,19,13,32,281,253,534
20172018,4,BALLARD,15,Ballard County,5,Ballard County Middle School,4015005,210021000035,WKEC,908,119,117,236,10,2,12,1,2,3,1,1,2,1,1,2,0,0,0,8,4,12,140,127,267
20172018,4,BALLARD,15,Ballard County,10,Ballard Memorial High School,4015010,210021000036,WKEC,908,200,143,343,5,10,15,2,4,6,1,0,1,0,0,0,0,0,0,10,5,15,218,162,380
20172018,4,BALLARD,15,Ballard County,,---District Total---,,,WKEC,908,570,489,1059,20,16,36,9,12,21,2,2,4,1,1,2,0,0,0,37,22,59,639,542,1181
20172018,61,KNOX,16,Barbourville Independent,11,Barbourville City School,61016011,210024001969,SESC,907,296,303,599,3,9,12,2,1,3,0,3,3,0,0,0,0,0,0,2,3,5,303,319,622
20172018,61,KNOX,16,Barbourville Independent,,---District Total---,,,SESC,907,296,303,599,3,9,12,2,1,3,0,3,3,0,0,0,0,0,0,2,3,5,303,319,622
20172018,90,NELSON,17,Bardstown Independent,5,Bardstown Alternative School,90017005,210027002359,CKEC,901,8,13,21,4,3,7,2,1,3,1,0,1,0,0,0,0,0,0,2,1,3,17,18,35
20172018,90,NELSON,17,Bardstown Independent,10,Bardstown Elementary School,90017010,210027000044,CKEC,901,223,190,413,34,34,68,21,21,42,10,8,18,1,0,1,0,0,0,41,38,79,330,291,621
20172018,90,NELSON,17,Bardstown Independent,20,Bardstown High School,90017020,210027000045,CKEC,901,215,195,410,59,50,109,15,19,34,1,4,5,1,0,1,0,0,0,18,15,33,309,283,592
20172018,90,NELSON,17,Bardstown Independent,30,Bardstown Middle School,90017030,210027000046,CKEC,901,213,201,414,46,45,91,22,24,46,5,6,11,1,0,1,0,0,0,22,22,44,309,298,607
20172018,90,NELSON,17,Bardstown Independent,12,Bardstown Primary School,90017012,210027002050,CKEC,901,204,202,406,36,31,67,28,16,44,6,5,11,0,0,0,0,0,0,29,42,71,303,296,599
20172018,90,NELSON,17,Bardstown Independent,,---District Total---,,,CKEC,901,863,801,1664,179,163,342,88,81,169,23,23,46,3,0,3,0,0,0,112,118,230,1268,1186,2454
20172018,5,BARREN,21,Barren County,10,Austin Tracy Elementary School,5021010,210030000047,GRREC,902,117,100,217,0,0,0,3,1,4,0,0,0,0,1,1,0,0,0,2,6,8,122,108,230
20172018,5,BARREN,21,Barren County,12,BAVEL,5021012,210030001970,GRREC,902,68,150,218,4,4,8,3,8,11,0,3,3,0,1,1,0,0,0,6,7,13,81,173,254
20172018,5,BARREN,21,Barren County,27,Barren County High School,5021027,210030000048,GRREC,902,561,605,1166,8,7,15,24,21,45,1,1,2,1,1,2,0,1,1,15,16,31,610,652,1262
20172018,5,BARREN,21,Barren County,50,Barren County Middle School,5021050,210030000607,GRREC,902,346,339,685,6,5,11,14,12,26,1,3,4,0,0,0,1,0,1,6,13,19,374,372,746
20172018,5,BARREN,21,Barren County,11,College Street Campus,5021011,210030001303,GRREC,902,36,30,66,2,1,3,0,1,1,0,0,0,0,0,0,0,0,0,0,0,0,38,32,70
20172018,5,BARREN,21,Barren County,35,Eastern Elementary School,5021035,210030000049,GRREC,902,162,162,324,3,1,4,8,4,12,2,0,2,0,0,0,1,0,1,0,0,0,176,167,343
20172018,5,BARREN,21,Barren County,80,Hiseville Elementary School,5021080,210030000050,GRREC,902,98,110,208,0,1,1,5,2,7,0,0,0,0,0,0,0,0,0,2,6,8,105,119,224
20172018,5,BARREN,21,Barren County,14,North Jackson Elementary,5021014,210030002232,GRREC,902,230,231,461,4,3,7,11,8,19,2,1,3,0,0,0,0,0,0,7,12,19,254,255,509
20172018,5,BARREN,21,Barren County,130,Park City Elementary School,5021130,210030000051,GRREC,902,172,160,332,3,4,7,10,17,27,1,0,1,0,0,0,0,0,0,12,11,23,198,192,390
20172018,5,BARREN,21,Barren County,150,Red Cross Elementary School,5021150,210030000052,GRREC,902,276,249,525,3,2,5,16,11,27,2,2,4,0,0,0,0,0,0,15,8,23,312,272,584
20172018,5,BARREN,21,Barren County,180,Temple Hill Elementary School,5021180,210030000053,GRREC,902,119,116,235,1,0,1,14,10,24,0,0,0,0,0,0,0,0,0,2,5,7,136,131,267
20172018,5,BARREN,21,Barren County,,---District Total---,,,GRREC,902,2185,2252,4437,34,28,62,108,95,203,9,10,19,1,3,4,2,1,3,67,84,151,2406,2473,4879
20172018,6,BATH,25,Bath County,40,Bath County High School,6025040,210033000057,KEDC,903,285,252,537,3,2,5,6,4,10,1,0,1,0,1,1,0,0,0,0,3,3,295,262,557
20172018,6,BATH,25,Bath County,20,Bath County Middle School,6025020,210033001606,KEDC,903,229,218,447,0,1,1,6,13,19,0,1,1,0,0,0,0,0,0,3,5,8,238,238,476
20172018,6,BATH,25,Bath County,14,Crossroads Elementary School,6025014,210033002223,KEDC,903,229,169,398,2,1,3,5,4,9,0,0,0,0,0,0,0,0,0,1,5,6,237,179,416
20172018,6,BATH,25,Bath County,30,Owingsville Elementary School,6025030,210033000056,KEDC,903,242,224,466,2,0,2,9,3,12,0,1,1,0,0,0,0,1,1,4,8,12,257,237,494
20172018,6,BATH,25,Bath County,12,Second Chance Academy,6025012,210033002335,KEDC,903,8,2,10,0,0,0,0,0,0,0,0,0,0,0,0,0,0,0,0,0,0,8,2,10
20172018,6,BATH,25,Bath County,,---District Total---,,,KEDC,903,993,865,1858,7,4,11,26,24,50,1,2,3,0,1,1,0,1,1,8,21,29,1035,918,1953
20172018,59,KENTON,26,Beechwood Independent,10,Beechwood Elementary School,59026010,210036000059,NKCES,905,301,291,592,2,2,4,32,30,62,6,8,14,1,1,2,0,1,1,11,6,17,353,339,692
20172018,59,KENTON,26,Beechwood Independent,20,Beechwood High School,59026020,210036000060,NKCES,905,322,262,584,1,1,2,14,9,23,6,12,18,5,0,5,0,0,0,5,9,14,353,293,646
20172018,59,KENTON,26,Beechwood Independent,420,Guardian Angel,59026420,210036002409,NKCES,905,28,7,35,0,1,1,1,0,1,0,0,0,0,0,0,0,0,0,2,0,2,31,8,39
20172018,59,KENTON,26,Beechwood Independent,,---District Total---,,,NKCES,905,651,560,1211,3,4,7,47,39,86,12,20,32,6,1,7,0,1,1,18,15,33,737,640,1377
20172018,7,BELL,31,Bell County,12,Bell Central School Center,7031012,210039001881,SESC,907,229,253,482,0,0,0,3,0,3,0,0,0,0,0,0,0,0,0,2,0,2,234,253,487
20172018,7,BELL,31,Bell County,340,Bell County Alternative School,7031340,210039000002,SESC,907,16,23,39,0,0,0,0,1,1,0,0,0,0,0,0,0,0,0,0,0,0,16,24,40
20172018,7,BELL,31,Bell County,40,Bell County High School,7031040,210039000062,SESC,907,371,301,672,3,1,4,3,3,6,1,0,1,1,0,1,1,0,1,1,2,3,381,307,688
20172018,7,BELL,31,Bell County,180,Frakes School Center,7031180,210039000067,SESC,907,63,51,114,2,1,3,1,1,2,0,0,0,0,0,0,0,0,0,1,0,1,67,53,120
20172018,7,BELL,31,Bell County,250,Lone Jack School Center,7031250,210039000068,SESC,907,100,72,172,1,1,2,0,1,1,0,0,0,0,0,0,0,0,0,0,1,1,101,75,176
20172018,7,BELL,31,Bell County,13,Page School Center,7031013,210039001882,SESC,907,166,154,320,1,0,1,1,1,2,0,0,0,0,0,0,0,0,0,1,1,2,169,156,325
20172018,7,BELL,31,Bell County,345,Right Fork School Center,7031345,210039000072,SESC,907,94,95,189,1,0,1,1,0,1,0,0,0,0,0,0,0,0,0,0,0,0,96,95,191
20172018,7,BELL,31,Bell County,390,Yellow Creek School Center,7031390,210039000074,SESC,907,262,296,558,2,3,5,4,2,6,1,0,1,1,0,1,0,0,0,1,0,1,271,301,572
20172018,7,BELL,31,Bell County,,---District Total---,,,SESC,907,1301,1245,2546,10,6,16,13,9,22,2,0,2,2,0,2,1,0,1,6,4,10,1335,1264,2599
20172018,19,CAMPBELL,32,Bellevue Independent,10,Bellevue High School,19032010,210042000075,NKCES,905,161,138,299,2,3,5,8,7,15,0,0,0,0,0,0,1,1,2,22,13,35,194,162,356
20172018,19,CAMPBELL,32,Bellevue Independent,20,Grandview Elementary School,19032020,210042000076,NKCES,905,128,116,244,5,4,9,6,7,13,0,1,1,0,0,0,0,2,2,13,11,24,152,141,293
20172018,19,CAMPBELL,32,Bellevue Independent,,---District Total---,,,NKCES,905,289,254,543,7,7,14,14,14,28,0,1,1,0,0,0,1,3,4,35,24,59,346,303,649
20172018,73,MADISON,34,Berea Independent,10,Berea Community Elementary School,73034010,210048000077,SESC,907,216,203,419,9,7,16,23,14,37,1,2,3,0,0,0,0,0,0,14,12,26,263,238,501
20172018,73,MADISON,34,Berea Independent,20,Berea Community High School,73034020,210048000078,SESC,907,132,134,266,4,5,9,11,7,18,0,3,3,0,0,0,2,0,2,6,6,12,155,155,310
20172018,73,MADISON,34,Berea Independent,15,Berea Community Middle School,73034015,210048001658,SESC,907,111,128,239,9,7,16,10,7,17,1,0,1,0,0,0,0,0,0,2,2,4,133,144,277
20172018,73,MADISON,34,Berea Independent,,---District Total---,,,SESC,907,459,465,924,22,19,41,44,28,72,2,5,7,0,0,0,2,0,2,22,20,42,551,537,1088
20172018,8,BOONE,35,Boone County,5,A M Yealey Elementary School,8035005,210051000079,NKCES,905,222,222,444,7,6,13,16,12,28,13,11,24,0,0,0,3,0,3,16,11,27,277,262,539
20172018,8,BOONE,35,Boone County,25,Ballyshannon Middle School,8035025,,NKCES,905,0,0,0,0,0,0,0,0,0,0,0,0,0,0,0,0,0,0,0,0,0,0,0,0
20172018,8,BOONE,35,Boone County,170,Boone County Alternative Center,8035170,210051002266,NKCES,905,155,114,269,11,8,19,11,10,21,1,0,1,0,0,0,0,2,2,11,3,14,189,137,326
20172018,8,BOONE,35,Boone County,30,Boone County High School,8035030,210051000081,NKCES,905,519,468,987,51,58,109,76,77,153,15,10,25,0,1,1,6,4,10,23,29,52,690,647,1337
20172018,8,BOONE,35,Boone County,16,Boone County Schools Ignite Academy,8035016,,NKCES,905,0,0,0,0,0,0,0,0,0,0,0,0,0,0,0,0,0,0,0,0,0,0,0,0
20172018,8,BOONE,35,Boone County,40,Burlington Elementary School,8035040,210051000082,NKCES,905,320,342,662,27,15,42,11,16,27,3,6,9,1,1,2,2,4,6,25,23,48,389,407,796
20172018,8,BOONE,35,Boone County,10,Camp Ernst Middle School,8035010,210051001971,NKCES,905,448,416,864,24,15,39,22,17,39,7,9,16,2,0,2,1,0,1,18,22,40,522,479,1001
20172018,8,BOONE,35,Boone County,41,Charles H. Kelly Elementary School,8035041,210051001519,NKCES,905,104,104,208,0,2,2,7,3,10,0,1,1,0,0,0,0,0,0,4,2,6,115,112,227
20172018,8,BOONE,35,Boone County,55,Chester Goodridge Elementary School,8035055,210051000086,NKCES,905,281,294,575,7,4,11,24,33,57,2,3,5,0,0,0,5,1,6,14,21,35,333,356,689
20172018,8,BOONE,35,Boone County,45,Conner High School,8035045,210051000084,NKCES,905,592,635,1227,22,24,46,25,22,47,15,15,30,0,0,0,1,3,4,22,22,44,677,721,1398
20172018,8,BOONE,35,Boone County,43,Conner Middle School,8035043,210051000083,NKCES,905,499,469,968,23,15,38,24,25,49,13,10,23,1,0,1,2,1,3,20,12,32,582,532,1114
20172018,8,BOONE,35,Boone County,6,Erpenbeck Elementary School,8035006,210051001710,NKCES,905,261,250,511,13,15,28,21,21,42,35,21,56,0,0,0,1,0,1,23,15,38,354,322,676
20172018,8,BOONE,35,Boone County,50,Florence Elementary School,8035050,210051000085,NKCES,905,160,156,316,44,29,73,52,44,96,5,3,8,0,0,0,9,6,15,15,18,33,285,256,541
20172018,8,BOONE,35,Boone County,75,Gray Middle School,8035075,210051000638,NKCES,905,489,453,942,10,5,15,32,26,58,11,17,28,0,0,0,1,1,2,10,10,20,553,512,1065
20172018,8,BOONE,35,Boone County,65,Hillard Collins Elementary School,8035065,210051001608,NKCES,905,203,181,384,51,48,99,141,97,238,2,1,3,0,0,0,0,0,0,33,33,66,430,360,790
20172018,8,BOONE,35,Boone County,14,Imagineering Academy,8035014,,NKCES,905,24,7,31,1,1,2,4,1,5,0,0,0,0,0,0,0,0,0,4,0,4,33,9,42
20172018,8,BOONE,35,Boone County,71,Larry A. Ryle High School,8035071,210051000011,NKCES,905,810,743,1553,26,33,59,77,76,153,24,27,51,0,0,0,1,1,2,21,27,48,959,907,1866
20172018,8,BOONE,35,Boone County,17,Longbranch Elementary School,8035017,210051002245,NKCES,905,347,346,693,9,10,19,7,16,23,8,5,13,0,0,0,0,3,3,17,26,43,388,406,794
20172018,8,BOONE,35,Boone County,80,New Haven Elementary School,8035080,210051000088,NKCES,905,425,331,756,8,8,16,35,30,65,5,12,17,0,0,0,0,0,0,15,11,26,488,392,880
20172018,8,BOONE,35,Boone County,8,North Pointe Elementary School,8035008,210051001883,NKCES,905,198,176,374,13,5,18,6,15,21,10,7,17,0,0,0,2,4,6,4,11,15,233,218,451
20172018,8,BOONE,35,Boone County,81,Ockerman Elementary School,8035081,210051000089,NKCES,905,234,230,464,28,14,42,93,94,187,7,6,13,0,0,0,2,1,3,14,14,28,378,359,737
20172018,8,BOONE,35,Boone County,85,Ockerman Middle School,8035085,210051000090,NKCES,905,349,297,646,15,14,29,18,26,44,13,14,27,2,1,3,1,2,3,16,16,32,414,370,784
20172018,8,BOONE,35,Boone County,15,Randall K. Cooper High School,8035015,210051002206,NKCES,905,612,568,1180,28,23,51,17,11,28,17,11,28,1,0,1,4,0,4,20,20,40,699,633,1332
20172018,8,BOONE,35,Boone County,20,Rector A. Jones Middle School,8035020,210051000080,NKCES,905,191,190,381,52,51,103,81,103,184,3,0,3,0,0,0,5,3,8,28,28,56,360,375,735
20172018,8,BOONE,35,Boone County,11,Shirley Mann Elementary School,8035011,210051002022,NKCES,905,329,331,660,4,8,12,12,13,25,20,20,40,1,1,2,0,0,0,4,9,13,370,382,752
20172018,8,BOONE,35,Boone County,83,Stephens Elementary School,8035083,210051001695,NKCES,905,268,242,510,16,4,20,24,15,39,4,5,9,0,0,0,1,1,2,18,13,31,331,280,611
20172018,8,BOONE,35,Boone County,12,Thornwilde Elementary School,8035012,210051002290,NKCES,905,273,270,543,16,14,30,15,9,24,5,7,12,0,0,0,0,0,0,22,19,41,331,319,650
20172018,8,BOONE,35,Boone County,,---District Total---,,,NKCES,905,8313,7835,16148,506,429,935,851,812,1663,238,221,459,8,4,12,47,37,84,417,415,832,10380,9753,20133
20172018,9,BOURBON,41,Bourbon County,10,Bourbon Central Elementary School,9041010,210054001576,CKEC,901,222,188,410,10,5,15,70,49,119,2,0,2,0,0,0,0,0,0,30,13,43,334,255,589
20172018,9,BOURBON,41,Bourbon County,110,Bourbon County High School,9041110,210054000098,CKEC,901,326,332,658,16,9,25,48,36,84,1,1,2,0,0,0,0,0,0,9,4,13,400,382,782
20172018,9,BOURBON,41,Bourbon County,120,Bourbon County Middle School,9041120,210054000099,CKEC,901,254,278,532,11,5,16,58,45,103,1,3,4,0,0,0,0,0,0,5,5,10,329,336,665
20172018,9,BOURBON,41,Bourbon County,30,Cane Ridge Elementary School,9041030,210054000024,CKEC,901,192,206,398,4,4,8,36,30,66,0,1,1,0,0,0,0,0,0,4,6,10,236,247,483
20172018,9,BOURBON,41,Bourbon County,90,North Middletown Elementary School,9041090,210054000096,CKEC,901,63,54,117,0,0,0,15,16,31,0,0,0,0,0,0,0,0,0,1,1,2,79,71,150
20172018,9,BOURBON,41,Bourbon County,,---District Total---,,,CKEC,901,1057,1058,2115,41,23,64,227,176,403,4,5,9,0,0,0,0,0,0,49,29,78,1378,1291,2669
20172018,114,WARREN,42,Bowling Green Independent,70,Bowling Green High School,114042070,210057000105,GRREC,902,343,318,661,115,120,235,102,87,189,25,37,62,3,0,3,1,1,2,16,16,32,605,579,1184
20172018,114,WARREN,42,Bowling Green Independent,65,Bowling Green Junior High,114042065,210057000104,GRREC,902,256,277,533,81,82,163,82,80,162,28,31,59,0,1,1,1,3,4,14,23,37,462,497,959
20172018,114,WARREN,42,Bowling Green Independent,98,Bowling Green Learning Center,114042098,210057001696,GRREC,902,20,7,27,14,8,22,9,3,12,1,0,1,1,0,1,0,0,0,4,2,6,49,20,69
20172018,114,WARREN,42,Bowling Green Independent,11,Childrens Crisis Stabilization Unit,114042011,210057001830,GRREC,902,2,1,3,0,0,0,0,0,0,0,0,0,0,0,0,0,0,0,0,0,0,2,1,3
20172018,114,WARREN,42,Bowling Green Independent,10,Dishman McGinnis Elementary School,114042010,210057000100,GRREC,902,67,65,132,62,63,125,80,82,162,15,14,29,1,1,2,3,1,4,12,10,22,240,236,476
20172018,114,WARREN,42,Bowling Green Independent,57,Parker-Bennett-Curry School,114042057,210057000102,GRREC,902,27,32,59,76,48,124,33,57,90,10,3,13,0,0,0,0,1,1,7,11,18,153,152,305
20172018,114,WARREN,42,Bowling Green Independent,60,Potter Gray Elementary,114042060,210057000103,GRREC,902,175,183,358,10,22,32,7,6,13,12,6,18,1,0,1,1,2,3,12,11,23,218,230,448
20172018,114,WARREN,42,Bowling Green Independent,80,T C Cherry Elementary School,114042080,210057000106,GRREC,902,74,80,154,20,13,33,15,13,28,4,1,5,0,0,0,0,3,3,12,13,25,125,123,248
20172018,114,WARREN,42,Bowling Green Independent,90,W R McNeill Elementary School,114042090,210057000107,GRREC,902,144,125,269,28,31,59,12,10,22,8,14,22,1,1,2,0,0,0,15,20,35,208,201,409
20172018,114,WARREN,42,Bowling Green Independent,13,Warren Regional Juvenile Detention Ctr,114042013,210057001911,GRREC,902,4,0,4,0,0,0,1,1,2,0,0,0,0,0,0,0,0,0,0,0,0,5,1,6
20172018,114,WARREN,42,Bowling Green Independent,,---District Total---,,,GRREC,902,1112,1088,2200,406,387,793,341,339,680,103,106,209,7,3,10,6,11,17,92,106,198,2067,2040,4107
20172018,10,BOYD,45,Boyd County,120,Boyd Co Career & Tech Educ Ctr Voc Sch,10045120,210062001479,KEDC,903,0,0,0,0,0,0,0,0,0,0,0,0,0,0,0,0,0,0,0,0,0,0,0,0
20172018,10,BOYD,45,Boyd County,10,Boyd County High School,10045010,210062000108,KEDC,903,468,356,824,2,2,4,3,5,8,1,1,2,0,0,0,0,0,0,8,1,9,482,365,847
20172018,10,BOYD,45,Boyd County,35,Boyd County Middle School,10045035,210062000112,KEDC,903,331,319,650,2,1,3,2,7,9,4,1,5,0,0,0,0,0,0,6,5,11,345,333,678
20172018,10,BOYD,45,Boyd County,20,Cannonsburg Elementary School,10045020,210062000109,KEDC,903,135,123,258,1,0,1,1,3,4,1,0,1,1,0,1,0,1,1,0,3,3,139,130,269
20172018,10,BOYD,45,Boyd County,95,Catlettsburg Elementary School,10045095,210062000118,KEDC,903,100,122,222,0,0,0,4,4,8,3,1,4,0,0,0,0,0,0,1,6,7,108,133,241
20172018,10,BOYD,45,Boyd County,97,Ponderosa Elementary School,10045097,210062000030,KEDC,903,182,189,371,2,0,2,0,0,0,0,0,0,0,0,0,0,1,1,3,4,7,187,194,381
20172018,10,BOYD,45,Boyd County,85,Ramey-Estep High School,10045085,210062000640,KEDC,903,45,22,67,12,0,12,2,0,2,0,0,0,0,0,0,0,0,0,3,2,5,62,24,86
20172018,10,BOYD,45,Boyd County,80,Summit Elementary School,10045080,210062000117,KEDC,903,224,217,441,1,0,1,1,3,4,0,0,0,2,0,2,1,1,2,11,9,20,240,230,470
20172018,10,BOYD,45,Boyd County,,---District Total---,,,KEDC,903,1485,1348,2833,20,3,23,13,22,35,9,3,12,3,0,3,1,3,4,32,30,62,1563,1409,2972
20172018,11,BOYLE,51,Boyle County,4,Boyle County Day Treatment,11051004,210063001713,CKEC,901,12,2,14,0,1,1,1,0,1,0,0,0,0,0,0,0,0,0,0,0,0,13,3,16
20172018,11,BOYLE,51,Boyle County,5,Boyle County High School,11051005,210063000120,CKEC,901,420,390,810,7,4,11,14,11,25,8,6,14,1,1,2,1,1,2,6,6,12,457,419,876
20172018,11,BOYLE,51,Boyle County,3,Boyle County Middle School,11051003,210063000119,CKEC,901,296,288,584,2,4,6,9,13,22,6,8,14,0,1,1,0,0,0,9,7,16,322,321,643
20172018,11,BOYLE,51,Boyle County,40,Junction City Elementary School,11051040,210063000121,CKEC,901,150,124,274,0,1,1,7,9,16,1,0,1,0,0,0,0,0,0,10,3,13,168,137,305
20172018,11,BOYLE,51,Boyle County,80,Perryville Elementary School,11051080,210063000124,CKEC,901,110,99,209,0,0,0,4,5,9,0,0,0,1,0,1,0,0,0,5,5,10,120,109,229
20172018,11,BOYLE,51,Boyle County,50,Woodlawn Elementary School,11051050,210063000122,CKEC,901,242,241,483,4,6,10,6,6,12,5,3,8,1,1,2,0,0,0,12,8,20,270,265,535
20172018,11,BOYLE,51,Boyle County,,---District Total---,,,CKEC,901,1230,1144,2374,13,16,29,41,44,85,20,17,37,3,3,6,1,1,2,42,29,71,1350,1254,2604
20172018,12,BRACKEN,55,Bracken County,10,Bracken County High School,12055010,210066000125,NKCES,905,191,173,364,0,0,0,4,3,7,0,0,0,0,0,0,0,0,0,2,4,6,197,180,377
20172018,12,BRACKEN,55,Bracken County,60,Bracken County Middle School,12055060,210066001560,NKCES,905,132,130,262,0,0,0,7,1,8,0,0,0,0,0,0,0,0,0,5,1,6,144,132,276
20172018,12,BRACKEN,55,Bracken County,50,Taylor Elementary School,12055050,210066000128,NKCES,905,283,227,510,0,0,0,7,3,10,0,0,0,0,0,0,0,0,0,10,9,19,300,239,539
20172018,12,BRACKEN,55,Bracken County,,---District Total---,,,NKCES,905,606,530,1136,0,0,0,18,7,25,0,0,0,0,0,0,0,0,0,17,14,31,641,551,1192
20172018,13,BREATHITT,61,Breathitt County,33,Breathitt County Day Treatment,13061033,210069001842,KVEC,904,6,0,6,5,0,5,1,0,1,0,0,0,0,0,0,0,0,0,1,0,1,13,0,13
20172018,13,BREATHITT,61,Breathitt County,60,Breathitt County High School,13061060,210069000129,KVEC,904,270,225,495,4,2,6,0,1,1,0,1,1,0,0,0,0,0,0,1,0,1,275,229,504
20172018,13,BREATHITT,61,Breathitt County,31,Breathitt Regional Juvenile Det Ctr,13061031,210069001623,KVEC,904,15,2,17,2,0,2,0,0,0,0,0,0,0,0,0,0,0,0,0,0,0,17,2,19
20172018,13,BREATHITT,61,Breathitt County,32,Breathitt Residential Treatment Center,13061032,210069001717,KVEC,904,0,0,0,0,0,0,0,0,0,0,0,0,0,0,0,0,0,0,0,0,0,0,0,0
20172018,13,BREATHITT,61,Breathitt County,30,Highland-Turner Elementary School,13061030,210069001659,KVEC,904,102,91,193,0,0,0,0,0,0,0,0,0,0,0,0,0,0,0,0,1,1,102,92,194
20172018,13,BREATHITT,61,Breathitt County,150,LBJ Elementary School,13061150,210069000132,KVEC,904,280,227,507,0,0,0,1,1,2,0,2,2,0,1,1,0,0,0,0,0,0,281,231,512
20172018,13,BREATHITT,61,Breathitt County,185,Marie Roberts-Caney Elementary School,13061185,210069000133,KVEC,904,126,110,236,0,0,0,2,3,5,0,0,0,0,0,0,0,0,0,0,0,0,128,113,241
20172018,13,BREATHITT,61,Breathitt County,390,Sebastian Middle School,13061390,210069000136,KVEC,904,157,118,275,2,0,2,1,2,3,0,0,0,0,1,1,0,0,0,0,0,0,160,121,281
20172018,13,BREATHITT,61,Breathitt County,,---District Total---,,,KVEC,904,956,773,1729,13,2,15,5,7,12,0,3,3,0,2,2,0,0,0,2,1,3,976,788,1764
20172018,14,BRECKINRIDGE,65,Breckinridge County,30,Ben Johnson Elementary School,14065030,210072000139,GRREC,902,114,89,203,1,1,2,0,0,0,1,0,1,0,1,1,0,0,0,3,3,6,119,94,213
20172018,14,BRECKINRIDGE,65,Breckinridge County,10,Breckinridge County High School,14065010,210072000137,GRREC,902,465,343,808,14,5,19,11,10,21,2,5,7,0,1,1,0,0,0,12,13,25,504,377,881
20172018,14,BRECKINRIDGE,65,Breckinridge County,100,Breckinridge County Middle School,14065100,210072001304,GRREC,902,293,264,557,8,9,17,6,7,13,1,0,1,1,0,1,0,0,0,10,10,20,319,290,609
20172018,14,BRECKINRIDGE,65,Breckinridge County,40,Custer Elementary School,14065040,210072000140,GRREC,902,88,84,172,0,1,1,6,5,11,0,2,2,0,1,1,0,0,0,7,1,8,101,94,195
20172018,14,BRECKINRIDGE,65,Breckinridge County,20,Hardinsburg Elementary School,14065020,210072000138,GRREC,902,173,164,337,4,7,11,6,3,9,3,1,4,0,1,1,0,0,0,8,13,21,194,189,383
20172018,14,BRECKINRIDGE,65,Breckinridge County,50,Irvington Elementary School,14065050,210072000141,GRREC,902,161,163,324,4,8,12,9,4,13,0,1,1,0,0,0,0,1,1,9,6,15,183,183,366
20172018,14,BRECKINRIDGE,65,Breckinridge County,,---District Total---,,,GRREC,902,1294,1107,2401,31,31,62,38,29,67,7,9,16,1,4,5,0,1,1,49,46,95,1420,1227,2647
20172018,15,BULLITT,71,Bullitt County,5,Bernheim Middle School,15071005,210075000414,OVEC,906,199,215,414,2,1,3,7,4,11,0,0,0,1,0,1,0,0,0,2,4,6,211,224,435
20172018,15,BULLITT,71,Bullitt County,10,Brooks Elementary School,15071010,210075000144,OVEC,906,188,189,377,3,9,12,16,14,30,2,1,3,0,1,1,0,0,0,8,14,22,217,228,445
20172018,15,BULLITT,71,Bullitt County,120,Bullitt Alternative Center,15071120,210075000929,OVEC,906,32,10,42,0,0,0,1,1,2,1,0,1,0,0,0,0,0,0,4,1,5,38,12,50
20172018,15,BULLITT,71,Bullitt County,15,Bullitt Central High School,15071015,210075000145,OVEC,906,659,622,1281,3,2,5,22,13,35,6,3,9,3,2,5,0,1,1,16,7,23,709,650,1359
20172018,15,BULLITT,71,Bullitt County,16,Bullitt East High School,15071016,210075001409,OVEC,906,733,667,1400,8,11,19,22,12,34,4,7,11,1,2,3,0,0,0,16,10,26,784,709,1493
20172018,15,BULLITT,71,Bullitt County,18,Bullitt Lick Middle School,15071018,210075001410,OVEC,906,220,236,456,4,2,6,14,6,20,3,1,4,0,1,1,1,0,1,12,5,17,254,251,505
20172018,15,BULLITT,71,Bullitt County,20,Cedar Grove Elementary,15071020,210075000146,OVEC,906,229,227,456,0,0,0,6,3,9,1,0,1,0,0,0,0,0,0,3,9,12,239,239,478
20172018,15,BULLITT,71,Bullitt County,60,Crossroads Elementary,15071060,210075002286,OVEC,906,201,212,413,1,2,3,11,8,19,3,1,4,0,1,1,0,0,0,20,13,33,236,237,473
20172018,15,BULLITT,71,Bullitt County,9,Eastside Middle School,15071009,210075001975,OVEC,906,298,285,583,5,2,7,6,5,11,0,2,2,1,2,3,0,0,0,9,11,20,319,307,626
20172018,15,BULLITT,71,Bullitt County,6,Freedom Elementary School,15071006,210075001958,OVEC,906,227,169,396,3,3,6,7,4,11,4,3,7,0,0,0,0,0,0,8,9,17,249,188,437
20172018,15,BULLITT,71,Bullitt County,25,Hebron Middle School,15071025,210075000147,OVEC,906,204,210,414,4,2,6,14,10,24,5,3,8,1,0,1,0,1,1,5,5,10,233,231,464
20172018,15,BULLITT,71,Bullitt County,30,Lebanon Junction Elementary,15071030,210075000148,OVEC,906,186,200,386,1,0,1,5,6,11,0,0,0,1,0,1,0,0,0,5,7,12,198,213,411
20172018,15,BULLITT,71,Bullitt County,55,MT. Washington Elementary,15071055,210075000151,OVEC,906,291,273,564,7,0,7,3,6,9,1,0,1,1,0,1,0,0,0,10,8,18,313,287,600
20172018,15,BULLITT,71,Bullitt County,50,MT. Washington Middle School,15071050,210075000150,OVEC,906,230,216,446,5,5,10,7,4,11,1,2,3,0,1,1,0,0,0,3,8,11,246,236,482
20172018,15,BULLITT,71,Bullitt County,45,Maryville Elementary School,15071045,210075000149,OVEC,906,154,123,277,3,1,4,11,8,19,0,0,0,0,0,0,0,0,0,5,10,15,173,142,315
20172018,15,BULLITT,71,Bullitt County,70,Nichols Elementary,15071070,210075000153,OVEC,906,56,64,120,0,0,0,5,6,11,0,0,0,1,0,1,0,0,0,2,1,3,64,71,135
20172018,15,BULLITT,71,Bullitt County,75,North Bullitt High School,15071075,210075000154,OVEC,906,590,542,1132,15,9,24,25,26,51,8,5,13,0,1,1,0,0,0,15,21,36,653,604,1257
20172018,15,BULLITT,71,Bullitt County,78,Old Mill Elementary School,15071078,210075001578,OVEC,906,234,191,425,2,3,5,4,5,9,5,5,10,0,0,0,0,0,0,9,3,12,254,207,461
20172018,15,BULLITT,71,Bullitt County,80,Overdale Elementary School,15071080,210075000155,OVEC,906,178,166,344,4,2,6,13,12,25,1,2,3,1,1,2,0,0,0,12,10,22,209,193,402
20172018,15,BULLITT,71,Bullitt County,65,Pleasant Grove Elementary School,15071065,210075001305,OVEC,906,311,261,572,4,0,4,3,6,9,3,3,6,0,0,0,0,0,0,5,9,14,326,279,605
20172018,15,BULLITT,71,Bullitt County,110,Riverview Opportunity Center,15071110,210075000157,OVEC,906,101,59,160,0,1,1,2,1,3,1,4,5,1,0,1,0,0,0,0,1,1,105,66,171
20172018,15,BULLITT,71,Bullitt County,90,Roby Elementary School,15071090,210075000156,OVEC,906,195,183,378,5,1,6,8,9,17,2,1,3,0,0,0,0,0,0,9,8,17,219,202,421
20172018,15,BULLITT,71,Bullitt County,8,Shepherdsville Elementary,15071008,210075001974,OVEC,906,235,230,465,5,6,11,7,5,12,0,1,1,0,0,0,1,0,1,10,7,17,258,249,507
20172018,15,BULLITT,71,Bullitt County,32,Spring Meadows,15071032,210075002169,OVEC,906,14,0,14,2,0,2,2,0,2,0,0,0,0,0,0,0,0,0,1,0,1,19,0,19
20172018,15,BULLITT,71,Bullitt County,7,Zoneton Middle School,15071007,210075001973,OVEC,906,201,191,392,3,3,6,15,11,26,2,2,4,2,1,3,0,0,0,5,12,17,228,220,448
20172018,15,BULLITT,71,Bullitt County,,---District Total---,,,OVEC,906,6166,5741,11907,89,65,154,236,185,421,53,46,99,14,13,27,2,2,4,194,193,387,6754,6245,12999
20172018,84,MERCER,72,Burgin Independent,30,Burgin Independent School,84072030,210078002407,CKEC,901,233,234,467,0,1,1,4,8,12,2,2,4,1,0,1,0,0,0,14,8,22,254,253,507
20172018,84,MERCER,72,Burgin Independent,,---District Total---,,,CKEC,901,233,234,467,0,1,1,4,8,12,2,2,4,1,0,1,0,0,0,14,8,22,254,253,507
20172018,16,BUTLER,75,Butler County,30,Butler County High School,16075030,210081000160,GRREC,902,300,282,582,1,1,2,31,15,46,2,2,4,0,0,0,0,0,0,3,5,8,337,305,642
20172018,16,BUTLER,75,Butler County,32,Butler County Learning Center,16075032,210081001977,GRREC,902,12,3,15,0,0,0,1,0,1,0,0,0,0,0,0,0,0,0,0,0,0,13,3,16
20172018,16,BUTLER,75,Butler County,35,Butler County Middle School,16075035,210081001697,GRREC,902,211,207,418,0,0,0,22,15,37,2,1,3,1,1,2,0,0,0,1,7,8,237,231,468
20172018,16,BUTLER,75,Butler County,110,Green River School,16075110,210081000163,GRREC,902,5,0,5,10,0,10,0,0,0,0,0,0,0,0,0,0,0,0,3,0,3,18,0,18
20172018,16,BUTLER,75,Butler County,120,Morgantown Elementary School,16075120,210081000164,GRREC,902,285,213,498,0,1,1,45,49,94,1,1,2,0,0,0,0,0,0,8,4,12,339,268,607
20172018,16,BUTLER,75,Butler County,31,North Butler Elementary,16075031,210081001976,GRREC,902,195,185,380,1,0,1,2,3,5,1,0,1,0,0,0,0,0,0,2,4,6,201,192,393
20172018,16,BUTLER,75,Butler County,,---District Total---,,,GRREC,902,1008,890,1898,12,2,14,101,82,183,6,4,10,1,1,2,0,0,0,17,20,37,1145,999,2144
20172018,17,CALDWELL,81,Caldwell County,70,Caldwell County Elementary School,17081070,210084000170,WKEC,908,199,187,386,15,20,35,4,6,10,0,0,0,0,0,0,0,0,0,13,16,29,231,229,460
20172018,17,CALDWELL,81,Caldwell County,10,Caldwell County High School,17081010,210084000166,WKEC,908,235,255,490,18,22,40,5,7,12,2,0,2,0,2,2,0,0,0,9,8,17,269,294,563
20172018,17,CALDWELL,81,Caldwell County,20,Caldwell County Middle School,17081020,210084000167,WKEC,908,178,172,350,18,15,33,10,0,10,2,1,3,0,0,0,0,0,0,5,11,16,213,199,412
20172018,17,CALDWELL,81,Caldwell County,30,Caldwell County Primary School,17081030,210084001660,WKEC,908,188,184,372,16,14,30,5,2,7,0,1,1,0,0,0,0,1,1,11,13,24,220,215,435
20172018,17,CALDWELL,81,Caldwell County,,---District Total---,,,WKEC,908,800,798,1598,67,71,138,24,15,39,4,2,6,0,2,2,0,1,1,38,48,86,933,937,1870
20172018,18,CALLOWAY,85,Calloway County,96,Calloway County Alternative Program,18085096,210087002370,WKEC,908,14,13,27,0,0,0,0,1,1,0,0,0,0,0,0,0,0,0,1,2,3,15,16,31
20172018,18,CALLOWAY,85,Calloway County,95,Calloway County Day Treatment,18085095,210087002366,WKEC,908,15,6,21,1,0,1,0,0,0,0,0,0,0,0,0,0,0,0,0,0,0,16,6,22
20172018,18,CALLOWAY,85,Calloway County,20,Calloway County High School,18085020,210087000171,WKEC,908,406,346,752,4,2,6,19,17,36,2,2,4,0,0,0,0,1,1,10,20,30,441,388,829
20172018,18,CALLOWAY,85,Calloway County,55,Calloway County Middle School,18085055,210087001411,WKEC,908,303,269,572,4,6,10,17,21,38,2,1,3,0,0,0,0,0,0,7,8,15,333,305,638
20172018,18,CALLOWAY,85,Calloway County,25,East Calloway Elementary School,18085025,210087000172,WKEC,908,148,138,286,0,0,0,7,10,17,0,0,0,0,0,0,1,0,1,10,7,17,166,155,321
20172018,18,CALLOWAY,85,Calloway County,35,North Calloway Elementary School,18085035,210087000173,WKEC,908,244,222,466,8,8,16,19,20,39,0,2,2,0,0,0,0,0,0,12,13,25,283,265,548
20172018,18,CALLOWAY,85,Calloway County,45,Southwest Calloway Elementary School,18085045,210087000174,WKEC,908,201,213,414,1,2,3,7,6,13,2,1,3,0,0,0,0,0,0,5,4,9,216,226,442
20172018,18,CALLOWAY,85,Calloway County,,---District Total---,,,WKEC,908,1331,1207,2538,18,18,36,69,75,144,6,6,12,0,0,0,1,1,2,45,54,99,1470,1361,2831
20172018,19,CAMPBELL,91,Campbell County,16,Alexandria Educational Center,19091016,210090001398,NKCES,905,18,20,38,2,0,2,1,0,1,1,0,1,0,0,0,0,0,0,2,0,2,24,20,44
20172018,19,CAMPBELL,91,Campbell County,100,Campbell County High School,19091100,210090000941,NKCES,905,684,619,1303,10,17,27,14,12,26,7,16,23,0,0,0,0,0,0,10,13,23,725,677,1402
20172018,19,CAMPBELL,91,Campbell County,11,Campbell County Middle School,19091011,210090001306,NKCES,905,503,490,993,14,17,31,13,7,20,8,4,12,0,0,0,1,1,2,9,22,31,548,541,1089
20172018,19,CAMPBELL,91,Campbell County,19,Campbell Ridge Elementary,19091019,210090001978,NKCES,905,263,288,551,2,3,5,4,2,6,4,0,4,1,1,2,0,1,1,8,9,17,282,304,586
20172018,19,CAMPBELL,91,Campbell County,35,Crossroads Elementary School,19091035,210090002198,NKCES,905,232,235,467,11,12,23,7,8,15,5,2,7,2,0,2,0,0,0,18,19,37,275,276,551
20172018,19,CAMPBELL,91,Campbell County,13,Donald E. Cline Elementary School,19091013,210090001335,NKCES,905,149,149,298,17,10,27,9,5,14,6,3,9,0,0,0,0,0,0,10,8,18,191,175,366
20172018,19,CAMPBELL,91,Campbell County,50,Grant's Lick Elementary School,19091050,210090000180,NKCES,905,164,152,316,2,1,3,3,1,4,2,2,4,0,0,0,0,0,0,2,2,4,173,158,331
20172018,19,CAMPBELL,91,Campbell County,12,John W. Reiley Elementary School,19091012,210090001320,NKCES,905,205,197,402,0,1,1,1,4,5,2,2,4,0,0,0,0,1,1,7,4,11,215,209,424
20172018,19,CAMPBELL,91,Campbell County,,---District Total---,,,NKCES,905,2218,2150,4368,58,61,119,52,39,91,35,29,64,3,1,4,1,3,4,66,77,143,2433,2360,4793
20172018,109,TAYLOR,92,Campbellsville Independent,11,Campbellsville Eagle Academy,109092011,210093001653,GRREC,902,8,5,13,0,0,0,1,0,1,0,0,0,0,0,0,0,0,0,2,0,2,11,5,16
20172018,109,TAYLOR,92,Campbellsville Independent,10,Campbellsville Elementary School,109092010,210093000182,GRREC,902,209,173,382,22,20,42,13,9,22,3,4,7,0,0,0,0,0,0,39,43,82,286,249,535
20172018,109,TAYLOR,92,Campbellsville Independent,20,Campbellsville High School,109092020,210093000183,GRREC,902,108,112,220,20,12,32,5,4,9,2,3,5,0,0,0,0,0,0,10,14,24,145,145,290
20172018,109,TAYLOR,92,Campbellsville Independent,25,Campbellsville Middle School,109092025,210093000184,GRREC,902,84,83,167,7,10,17,4,3,7,2,1,3,0,0,0,0,0,0,7,14,21,104,111,215
20172018,109,TAYLOR,92,Campbellsville Independent,,---District Total---,,,GRREC,902,409,373,782,49,42,91,23,16,39,7,8,15,0,0,0,0,0,0,58,71,129,546,510,1056
20172018,20,CARLISLE,95,Carlisle County,60,Carlisle County Elementary School,20095060,210096000187,WKEC,908,146,140,286,0,0,0,10,12,22,0,0,0,0,0,0,0,0,0,5,4,9,161,156,317
20172018,20,CARLISLE,95,Carlisle County,40,Carlisle County High School,20095040,210096000186,WKEC,908,113,95,208,1,3,4,4,5,9,1,0,1,0,0,0,0,0,0,0,1,1,119,104,223
20172018,20,CARLISLE,95,Carlisle County,20,Carlisle County Middle School,20095020,210096000185,WKEC,908,82,80,162,1,4,5,3,5,8,1,0,1,0,0,0,0,0,0,2,2,4,89,91,180
20172018,20,CARLISLE,95,Carlisle County,,---District Total---,,,WKEC,908,341,315,656,2,7,9,17,22,39,2,0,2,0,0,0,0,0,0,7,7,14,369,351,720
20172018,21,CARROLL,101,Carroll County,50,Carroll County Alt Learning Center,21101050,210099000648,OVEC,906,11,6,17,0,0,0,1,1,2,0,0,0,0,0,0,0,0,0,1,1,2,13,8,21
20172018,21,CARROLL,101,Carroll County,18,Carroll County High School,21101018,210099000190,OVEC,906,213,219,432,5,2,7,28,26,54,1,2,3,0,0,0,0,0,0,11,8,19,258,257,515
20172018,21,CARROLL,101,Carroll County,19,Carroll County Middle School,21101019,210099000191,OVEC,906,170,158,328,3,1,4,30,29,59,1,1,2,1,0,1,0,0,0,15,7,22,220,196,416
20172018,21,CARROLL,101,Carroll County,5,Cartmell Elementary,21101005,210099000188,OVEC,906,203,187,390,1,3,4,38,36,74,0,0,0,0,0,0,0,0,0,8,12,20,250,238,488
20172018,21,CARROLL,101,Carroll County,10,Kathryn Winn Primary,21101010,210099000189,OVEC,906,193,176,369,1,0,1,37,33,70,0,0,0,0,0,0,0,0,0,13,14,27,244,223,467
20172018,21,CARROLL,101,Carroll County,15,iLead Academy,21101015,210099002417,OVEC,906,0,0,0,0,0,0,0,0,0,0,0,0,0,0,0,0,0,0,0,0,0,0,0,0
20172018,21,CARROLL,101,Carroll County,,---District Total---,,,OVEC,906,790,746,1536,10,6,16,134,125,259,2,3,5,1,0,1,0,0,0,48,42,90,985,922,1907
20172018,22,CARTER,105,Carter County,60,Carter City Elementary School,22105060,210102002356,KEDC,903,59,53,112,0,0,0,1,4,5,0,0,0,0,0,0,0,0,0,0,0,0,60,57,117
20172018,22,CARTER,105,Carter County,905,Carter County Career and Technical Center,22105905,210102001439,KEDC,903,0,0,0,0,0,0,0,0,0,0,0,0,0,0,0,0,0,0,0,0,0,0,0,0
20172018,22,CARTER,105,Carter County,40,Carter Virtual Academy,22105040,210102002294,KEDC,903,4,5,9,0,0,0,0,0,0,0,0,0,0,0,0,0,0,0,0,0,0,4,5,9
20172018,22,CARTER,105,Carter County,120,East Carter County High School,22105120,210102000194,KEDC,903,345,327,672,2,0,2,4,4,8,1,3,4,0,0,0,2,0,2,2,4,6,356,338,694
20172018,22,CARTER,105,Carter County,130,East Carter Middle School,22105130,210102001698,KEDC,903,302,226,528,0,0,0,5,3,8,1,1,2,0,0,0,0,0,0,3,2,5,311,232,543
20172018,22,CARTER,105,Carter County,52,Heritage Elementary School,22105052,210102001884,KEDC,903,168,153,321,0,0,0,0,2,2,0,0,0,0,0,0,0,0,0,1,3,4,169,158,327
20172018,22,CARTER,105,Carter County,250,Olive Hill Elementary School,22105250,210102000198,KEDC,903,196,195,391,0,2,2,3,1,4,0,0,0,0,0,0,0,0,0,1,2,3,200,200,400
20172018,22,CARTER,105,Carter County,340,Prichard Elementary School,22105340,210102000199,KEDC,903,301,268,569,0,0,0,13,13,26,1,3,4,0,0,0,0,1,1,2,4,6,317,289,606
20172018,22,CARTER,105,Carter County,450,Star Elementary School,22105450,210102000200,KEDC,903,60,55,115,0,0,0,1,0,1,0,0,0,0,0,0,0,0,0,0,0,0,61,55,116
20172018,22,CARTER,105,Carter County,53,Tygart Creek Elementary School,22105053,210102002340,KEDC,903,169,185,354,1,2,3,3,3,6,0,0,0,2,0,2,0,0,0,0,4,4,175,194,369
20172018,22,CARTER,105,Carter County,500,West Carter County High School,22105500,210102000202,KEDC,903,293,232,525,2,0,2,3,0,3,1,0,1,0,0,0,1,0,1,1,1,2,301,233,534
20172018,22,CARTER,105,Carter County,505,West Carter Middle School,22105505,210102001661,KEDC,903,244,194,438,1,0,1,0,2,2,0,0,0,0,0,0,0,1,1,0,3,3,245,200,445
20172018,22,CARTER,105,Carter County,,---District Total---,,,KEDC,903,2141,1893,4034,6,4,10,33,32,65,4,7,11,2,0,2,3,2,5,10,23,33,2199,1961,4160
20172018,23,CASEY,111,Casey County,45,Casey County High School,23111045,210105000204,SESC,907,310,316,626,2,0,2,16,12,28,1,0,1,0,1,1,0,0,0,9,3,12,338,332,670
20172018,23,CASEY,111,Casey County,70,Casey County Middle School,23111070,210105001579,SESC,907,162,132,294,0,0,0,8,10,18,0,2,2,0,0,0,0,0,0,3,1,4,173,145,318
20172018,23,CASEY,111,Casey County,26,Jones Park Elementary,23111026,210105001981,SESC,907,170,156,326,0,1,1,4,3,7,1,0,1,0,0,0,0,0,0,6,6,12,181,166,347
20172018,23,CASEY,111,Casey County,190,Liberty Elementary School,23111190,210105000208,SESC,907,150,165,315,0,0,0,21,27,48,2,1,3,0,0,0,2,1,3,6,8,14,181,202,383
20172018,23,CASEY,111,Casey County,15,Walnut Hill Elementary School,23111015,210105002211,SESC,907,233,220,453,3,1,4,21,22,43,2,0,2,2,0,2,0,0,0,5,5,10,266,248,514
20172018,23,CASEY,111,Casey County,,---District Total---,,,SESC,907,1025,989,2014,5,2,7,70,74,144,6,3,9,2,1,3,2,1,3,29,23,52,1139,1093,2232
20172018,5,BARREN,113,Caverna Independent,25,Caverna Elementary School,5113025,210111000213,GRREC,902,118,90,208,14,21,35,12,10,22,0,0,0,1,0,1,0,0,0,20,10,30,165,131,296
20172018,5,BARREN,113,Caverna Independent,30,Caverna High School,5113030,210111000214,GRREC,902,89,64,153,14,6,20,2,3,5,1,0,1,1,0,1,0,0,0,9,10,19,116,83,199
20172018,5,BARREN,113,Caverna Independent,26,Caverna Middle School,5113026,210111001914,GRREC,902,53,40,93,4,10,14,1,3,4,0,0,0,0,0,0,0,0,0,6,7,13,64,60,124
20172018,5,BARREN,113,Caverna Independent,,---District Total---,,,GRREC,902,260,194,454,32,37,69,15,16,31,1,0,1,2,0,2,0,0,0,35,27,62,345,274,619
20172018,24,CHRISTIAN,115,Christian County,100,Christian County Alternative School,24115100,210115001402,WKEC,908,0,0,0,0,0,0,0,0,0,0,0,0,0,0,0,0,0,0,0,0,0,0,0,0
20172018,24,CHRISTIAN,115,Christian County,180,Christian County Day Treatment,24115180,210115000234,WKEC,908,11,2,13,3,5,8,2,0,2,0,0,0,0,0,0,0,0,0,2,1,3,18,8,26
20172018,24,CHRISTIAN,115,Christian County,30,Christian County High School,24115030,210115000220,WKEC,908,343,329,672,240,226,466,31,28,59,3,2,5,0,3,3,0,1,1,28,15,43,645,604,1249
20172018,24,CHRISTIAN,115,Christian County,35,Christian County Middle School,24115035,210115000221,WKEC,908,180,181,361,133,111,244,18,21,39,3,1,4,1,1,2,2,1,3,19,14,33,356,330,686
20172018,24,CHRISTIAN,115,Christian County,40,Crofton Elementary School,24115040,210115000222,WKEC,908,181,164,345,6,3,9,4,7,11,0,0,0,0,1,1,0,0,0,7,10,17,198,185,383
20172018,24,CHRISTIAN,115,Christian County,23,Cumberland Hall School,24115023,210115001912,WKEC,908,7,10,17,2,0,2,0,0,0,0,0,0,0,0,0,0,0,0,0,0,0,9,10,19
20172018,24,CHRISTIAN,115,Christian County,26,Freedom Elementary School,24115026,210115002415,WKEC,908,95,90,185,176,170,346,22,23,45,0,0,0,0,0,0,0,1,1,15,31,46,308,315,623
20172018,24,CHRISTIAN,115,Christian County,975,Gateway Academy to Innovation & Tech.,24115975,210115001938,WKEC,908,0,0,0,0,0,0,0,0,0,0,0,0,0,0,0,0,0,0,0,0,0,0,0,0
20172018,24,CHRISTIAN,115,Christian County,50,Hopkinsville High School,24115050,210115000223,WKEC,908,312,304,616,188,191,379,40,40,80,7,5,12,2,0,2,1,2,3,18,29,47,568,571,1139
20172018,24,CHRISTIAN,115,Christian County,58,Hopkinsville Middle School,24115058,210115000225,WKEC,908,158,136,294,101,94,195,30,28,58,7,4,11,0,1,1,2,2,4,18,18,36,316,283,599
20172018,24,CHRISTIAN,115,Christian County,55,Indian Hills Elementary School,24115055,210115000224,WKEC,908,119,105,224,77,87,164,30,23,53,1,0,1,0,1,1,3,0,3,22,19,41,252,235,487
20172018,24,CHRISTIAN,115,Christian County,17,Martin Luther King Jr. Elementary School,24115017,210115002024,WKEC,908,117,124,241,151,154,305,21,29,50,0,1,1,1,1,2,0,2,2,23,18,41,313,329,642
20172018,24,CHRISTIAN,115,Christian County,125,Millbrooke Elementary School,24115125,210115000229,WKEC,908,247,211,458,99,90,189,22,13,35,1,3,4,0,2,2,0,1,1,32,29,61,401,349,750
20172018,24,CHRISTIAN,115,Christian County,130,Pembroke Elementary School,24115130,210115000231,WKEC,908,175,162,337,103,98,201,47,48,95,1,0,1,1,0,1,3,1,4,40,40,80,370,349,719
20172018,24,CHRISTIAN,115,Christian County,150,Sinking Fork Elementary School,24115150,210115000232,WKEC,908,125,124,249,70,83,153,15,7,22,0,1,1,0,0,0,0,1,1,8,17,25,218,233,451
20172018,24,CHRISTIAN,115,Christian County,170,South Christian Elementary School,24115170,210115000233,WKEC,908,175,140,315,95,69,164,39,23,62,5,6,11,3,1,4,3,1,4,30,15,45,350,255,605
20172018,24,CHRISTIAN,115,Christian County,,---District Total---,,,WKEC,908,2245,2082,4327,1444,1381,2825,321,290,611,28,23,51,8,11,19,14,13,27,262,256,518,4322,4056,8378
20172018,25,CLARK,121,Clark County,30,George Rogers Clark High School,25121030,210120000237,CKEC,901,647,640,1287,56,43,99,49,36,85,5,4,9,2,1,3,0,1,1,18,23,41,777,748,1525
20172018,25,CLARK,121,Clark County,13,Phoenix Academy,25121013,210120001624,CKEC,901,35,12,47,3,0,3,4,1,5,0,0,0,0,0,0,0,0,0,0,1,1,42,14,56
20172018,25,CLARK,121,Clark County,26,Rev. Henry E. Baker Sr. Interm. School,25121026,210120002389,CKEC,901,398,340,738,23,25,48,23,31,54,1,3,4,1,1,2,2,0,2,12,21,33,460,421,881
20172018,25,CLARK,121,Clark County,23,Robert D. Campbell Jr. High,25121023,210120002402,CKEC,901,354,335,689,22,27,49,28,21,49,3,5,8,0,0,0,0,1,1,14,6,20,421,395,816
20172018,25,CLARK,121,Clark County,6,Shearer Elementary School,25121006,210120002397,CKEC,901,178,152,330,4,1,5,18,15,33,2,2,4,0,2,2,0,0,0,12,10,22,214,182,396
20172018,25,CLARK,121,Clark County,4,Strode Station Elementary School,25121004,210120002395,CKEC,901,215,187,402,7,18,25,22,14,36,3,6,9,0,0,0,1,2,3,19,14,33,267,241,508
20172018,25,CLARK,121,Clark County,8,William G. Conkwright Elementary,25121008,210120002391,CKEC,901,223,207,430,19,11,30,16,15,31,0,2,2,0,1,1,0,0,0,4,8,12,262,244,506
20172018,25,CLARK,121,Clark County,2,Willis H. Justice Elementary School,25121002,210120002405,CKEC,901,206,148,354,13,17,30,18,16,34,2,0,2,0,1,1,0,0,0,15,11,26,254,193,447
20172018,25,CLARK,121,Clark County,,---District Total---,,,CKEC,901,2256,2021,4277,147,142,289,178,149,327,16,22,38,3,6,9,3,4,7,94,94,188,2697,2438,5135
20172018,26,CLAY,125,Clay County,40,Big Creek Elementary,26125040,210123000247,SESC,907,99,100,199,0,1,1,0,0,0,0,0,0,0,0,0,0,0,0,0,0,0,99,101,200
20172018,26,CLAY,125,Clay County,70,Burning Springs Elementary,26125070,210123000248,SESC,907,123,158,281,1,1,2,0,1,1,0,0,0,0,1,1,0,0,0,0,1,1,124,162,286
20172018,26,CLAY,125,Clay County,100,Clay County High School,26125100,210123000249,SESC,907,403,356,759,7,5,12,1,5,6,0,1,1,0,0,0,0,0,0,4,1,5,415,368,783
20172018,26,CLAY,125,Clay County,95,Clay County Middle School,26125095,210123001699,SESC,907,216,237,453,1,3,4,0,0,0,0,0,0,0,0,0,0,0,0,3,1,4,220,241,461
20172018,26,CLAY,125,Clay County,200,Goose Rock Elementary,26125200,210123000251,SESC,907,109,71,180,0,0,0,3,0,3,0,0,0,0,0,0,0,0,0,0,0,0,112,71,183
20172018,26,CLAY,125,Clay County,220,Hacker Elementary School,26125220,210123000252,SESC,907,144,117,261,0,0,0,2,1,3,1,1,2,0,0,0,0,0,0,0,2,2,147,121,268
20172018,26,CLAY,125,Clay County,41,Horse Creek Learning Center,26125041,210123001846,SESC,907,36,19,55,0,1,1,0,1,1,0,0,0,0,0,0,0,0,0,1,1,2,37,22,59
20172018,26,CLAY,125,Clay County,500,Manchester Elementary School,26125500,210123000255,SESC,907,193,194,387,7,7,14,0,5,5,0,0,0,0,0,0,1,1,2,1,4,5,202,211,413
20172018,26,CLAY,125,Clay County,570,Oneida Elementary School,26125570,210123000256,SESC,907,59,56,115,1,0,1,0,0,0,0,0,0,0,0,0,0,0,0,0,0,0,60,56,116
20172018,26,CLAY,125,Clay County,580,Paces Creek Elementary,26125580,210123001413,SESC,907,168,140,308,1,0,1,2,1,3,0,3,3,0,0,0,0,0,0,0,1,1,171,145,316
20172018,26,CLAY,125,Clay County,,---District Total---,,,SESC,907,1550,1448,2998,18,18,36,8,14,22,1,5,6,0,1,1,1,1,2,9,11,20,1587,1498,3085
20172018,27,CLINTON,131,Clinton County,15,Albany Elementary School,27131015,210126000257,GRREC,902,246,235,481,0,2,2,26,15,41,0,1,1,0,0,0,0,0,0,0,0,0,272,253,525
20172018,27,CLINTON,131,Clinton County,20,Clinton County Early Childhood Center,27131020,210126002228,GRREC,902,58,65,123,0,1,1,1,2,3,0,0,0,0,0,0,0,0,0,0,0,0,59,68,127
20172018,27,CLINTON,131,Clinton County,50,Clinton County High School,27131050,210126000259,GRREC,902,219,244,463,0,1,1,12,16,28,0,1,1,1,0,1,0,0,0,1,1,2,233,263,496
20172018,27,CLINTON,131,Clinton County,45,Clinton County Middle School,27131045,210126000444,GRREC,902,242,213,455,1,1,2,12,14,26,0,0,0,0,0,0,0,1,1,1,0,1,256,229,485
20172018,27,CLINTON,131,Clinton County,16,Foothills Academy,27131016,210126002162,GRREC,902,58,0,58,13,0,13,1,0,1,0,0,0,0,0,0,0,0,0,0,0,0,72,0,72
20172018,27,CLINTON,131,Clinton County,,---District Total---,,,GRREC,902,823,757,1580,14,5,19,52,47,99,0,2,2,1,0,1,0,1,1,2,1,3,892,813,1705
20172018,14,BRECKINRIDGE,132,Cloverport Independent,10,Frederick Fraize High School,14132010,210129000261,GRREC,902,58,57,115,2,1,3,1,1,2,0,0,0,0,0,0,0,0,0,1,0,1,62,59,121
20172018,14,BRECKINRIDGE,132,Cloverport Independent,25,Frederick Fraize Middle School,14132025,210129000907,GRREC,902,49,41,90,0,2,2,0,0,0,0,0,0,0,0,0,0,0,0,0,1,1,49,44,93
20172018,14,BRECKINRIDGE,132,Cloverport Independent,20,William H Natcher Elementary School,14132020,210129000262,GRREC,902,76,73,149,2,1,3,1,1,2,0,0,0,0,0,0,0,0,0,1,2,3,80,77,157
20172018,14,BRECKINRIDGE,132,Cloverport Independent,,---District Total---,,,GRREC,902,183,171,354,4,4,8,2,2,4,0,0,0,0,0,0,0,0,0,2,3,5,191,180,371
20172018,118,WHITLEY,133,Corbin Independent,12,Corbin Educational Center,118133012,210132001622,SESC,907,29,11,40,0,0,0,1,2,3,0,0,0,0,0,0,0,0,0,0,0,0,30,13,43
20172018,118,WHITLEY,133,Corbin Independent,17,Corbin Elementary,118133017,210132002239,SESC,907,222,185,407,1,0,1,5,6,11,1,0,1,0,0,0,0,0,0,4,1,5,233,192,425
20172018,118,WHITLEY,133,Corbin Independent,40,Corbin High School,118133040,210132000266,SESC,907,426,427,853,0,0,0,7,7,14,7,11,18,1,1,2,0,0,0,4,3,7,445,449,894
20172018,118,WHITLEY,133,Corbin Independent,18,Corbin Intermediate,118133018,210132002231,SESC,907,220,198,418,1,0,1,7,10,17,2,0,2,0,0,0,0,1,1,1,4,5,231,213,444
20172018,118,WHITLEY,133,Corbin Independent,50,Corbin Middle School,118133050,210132001414,SESC,907,237,197,434,0,0,0,7,9,16,2,3,5,0,0,0,0,0,0,5,2,7,251,211,462
20172018,118,WHITLEY,133,Corbin Independent,70,Corbin Primary,118133070,210132002218,SESC,907,302,264,566,0,0,0,12,7,19,0,1,1,0,0,0,1,0,1,4,3,7,319,275,594
20172018,118,WHITLEY,133,Corbin Independent,100,Corbin School of Innovation,118133100,210132002367,SESC,907,42,64,106,0,0,0,1,0,1,0,0,0,0,0,0,0,0,0,1,0,1,44,64,108
20172018,118,WHITLEY,133,Corbin Independent,,---District Total---,,,SESC,907,1495,1374,2869,2,0,2,40,41,81,12,15,27,1,1,2,1,1,2,19,13,32,1570,1445,3015
20172018,59,KENTON,134,Covington Independent,906,Chapman Vocational Education Center,59134906,210135002338,NKCES,905,0,0,0,0,0,0,0,0,0,0,0,0,0,0,0,0,0,0,0,0,0,0,0,0
20172018,59,KENTON,134,Covington Independent,11,Covington Adult High School,59134011,210135001495,NKCES,905,5,5,10,5,4,9,1,0,1,0,0,0,0,0,0,0,0,0,2,1,3,13,10,23
20172018,59,KENTON,134,Covington Independent,160,Glenn O Swing Elementary,59134160,210135000275,NKCES,905,115,115,230,63,61,124,41,47,88,0,0,0,0,0,0,2,0,2,16,20,36,237,243,480
20172018,59,KENTON,134,Covington Independent,19,Holmes High School,59134019,210135002049,NKCES,905,170,168,338,115,105,220,67,33,100,0,0,0,1,1,2,1,2,3,33,38,71,387,347,734
20172018,59,KENTON,134,Covington Independent,17,Holmes Middle School,59134017,210135001944,NKCES,905,178,132,310,113,115,228,53,40,93,0,0,0,0,1,1,1,2,3,43,39,82,388,329,717
20172018,59,KENTON,134,Covington Independent,110,John G Carlisle Elementary,59134110,210135000270,NKCES,905,71,47,118,39,34,73,48,49,97,0,0,0,0,0,0,0,0,0,17,14,31,175,144,319
20172018,59,KENTON,134,Covington Independent,115,Latonia Elementary School,59134115,210135000271,NKCES,905,111,96,207,53,58,111,8,9,17,0,0,0,0,0,0,1,1,2,19,16,35,192,180,372
20172018,59,KENTON,134,Covington Independent,150,Ninth District Elementary,59134150,210135000274,NKCES,905,71,71,142,55,79,134,29,20,49,0,0,0,0,0,0,1,2,3,26,19,45,182,191,373
20172018,59,KENTON,134,Covington Independent,170,Sixth District Elementary School,59134170,210135000276,NKCES,905,79,71,150,74,57,131,49,40,89,0,0,0,0,0,0,2,0,2,19,17,36,223,185,408
20172018,59,KENTON,134,Covington Independent,13,Transformational Learning Center,59134013,210135001783,NKCES,905,28,6,34,21,12,33,3,0,3,0,0,0,0,0,0,0,0,0,3,4,7,55,22,77
20172018,59,KENTON,134,Covington Independent,,---District Total---,,,NKCES,905,828,711,1539,538,525,1063,299,238,537,0,0,0,1,2,3,8,7,15,178,168,346,1852,1651,3503
20172018,28,CRITTENDEN,135,Crittenden County,100,Crittenden County Elementary School,28135100,210138001441,WKEC,908,291,261,552,1,0,1,6,4,10,1,0,1,1,1,2,0,0,0,13,7,20,313,273,586
20172018,28,CRITTENDEN,135,Crittenden County,20,Crittenden County High School,28135020,210138000279,WKEC,908,175,162,337,1,1,2,2,1,3,0,0,0,0,1,1,0,0,0,4,3,7,182,168,350
20172018,28,CRITTENDEN,135,Crittenden County,25,Crittenden County Middle School,28135025,210138000280,WKEC,908,170,153,323,1,1,2,2,2,4,0,0,0,1,1,2,0,0,0,2,1,3,176,158,334
20172018,28,CRITTENDEN,135,Crittenden County,22,Pathway Academy High School,28135022,210138002225,WKEC,908,2,1,3,0,0,0,0,0,0,0,0,0,0,0,0,0,0,0,0,0,0,2,1,3
20172018,28,CRITTENDEN,135,Crittenden County,,---District Total---,,,WKEC,908,638,577,1215,3,2,5,10,7,17,1,0,1,2,3,5,0,0,0,19,11,30,673,600,1273
20172018,29,CUMBERLAND,141,Cumberland County,70,Cumberland County Elementary School,29141070,210141000286,GRREC,902,200,195,395,2,3,5,6,4,10,0,0,0,0,0,0,0,0,0,9,18,27,217,220,437
20172018,29,CUMBERLAND,141,Cumberland County,80,Cumberland County High School,29141080,210141000287,GRREC,902,117,130,247,3,1,4,3,5,8,1,1,2,0,0,0,0,0,0,4,0,4,128,137,265
20172018,29,CUMBERLAND,141,Cumberland County,75,Cumberland County Middle School,29141075,210141001561,GRREC,902,81,93,174,2,1,3,3,2,5,0,0,0,0,1,1,0,0,0,5,5,10,91,102,193
20172018,29,CUMBERLAND,141,Cumberland County,,---District Total---,,,GRREC,902,398,418,816,7,5,12,12,11,23,1,1,2,0,1,1,0,0,0,18,23,41,436,459,895
20172018,11,BOYLE,143,Danville Independent,30,Danville High School,11143030,210144000291,CKEC,901,157,157,314,54,49,103,26,24,50,3,4,7,1,0,1,0,0,0,26,27,53,267,261,528
20172018,11,BOYLE,143,Danville Independent,10,Edna L. Toliver Intermediate School,11143010,,CKEC,901,0,0,0,0,0,0,0,0,0,0,0,0,0,0,0,0,0,0,0,0,0,0,0,0
20172018,11,BOYLE,143,Danville Independent,40,Hogsett Elementary School,11143040,210144000292,CKEC,901,76,60,136,24,24,48,32,34,66,0,0,0,0,2,2,0,0,0,15,12,27,147,132,279
20172018,11,BOYLE,143,Danville Independent,110,Jennie Rogers Elementary School,11143110,210144000294,CKEC,901,98,90,188,31,23,54,12,10,22,2,1,3,1,0,1,0,0,0,15,16,31,159,140,299
20172018,11,BOYLE,143,Danville Independent,5,John W. Bate Middle School,11143005,210144000290,CKEC,901,119,117,236,34,44,78,20,20,40,0,3,3,0,0,0,0,0,0,32,17,49,205,201,406
20172018,11,BOYLE,143,Danville Independent,3,Mary G. Hogsett Primary School,11143003,,CKEC,901,0,0,0,0,0,0,0,0,0,0,0,0,0,0,0,0,0,0,0,0,0,0,0,0
20172018,11,BOYLE,143,Danville Independent,350,Sunrise Academy,11143350,210144000646,CKEC,901,27,0,27,1,0,1,0,0,0,0,0,0,0,0,0,0,0,0,0,0,0,28,0,28
20172018,11,BOYLE,143,Danville Independent,60,Toliver Elementary School,11143060,210144000293,CKEC,901,107,94,201,21,17,38,18,13,31,1,1,2,0,0,0,0,0,0,14,21,35,161,146,307
20172018,11,BOYLE,143,Danville Independent,,---District Total---,,,CKEC,901,584,518,1102,165,157,322,108,101,209,6,9,15,2,2,4,0,0,0,102,93,195,967,880,1847
20172018,30,DAVIESS,145,Daviess County,5,Apollo High School,30145005,210147000295,GRREC,902,583,530,1113,41,29,70,34,39,73,26,33,59,2,0,2,1,6,7,26,26,52,713,663,1376
20172018,30,DAVIESS,145,Daviess County,85,Audubon Elementary School,30145085,210147000054,GRREC,902,196,147,343,13,12,25,6,7,13,3,9,12,0,0,0,0,0,0,13,14,27,231,189,420
20172018,30,DAVIESS,145,Daviess County,155,College View Middle School,30145155,210147000961,GRREC,902,385,357,742,13,11,24,23,28,51,25,18,43,1,0,1,0,1,1,15,7,22,462,422,884
20172018,30,DAVIESS,145,Daviess County,150,Country Heights Elementary School,30145150,210147001581,GRREC,902,191,219,410,4,2,6,8,9,17,4,5,9,0,0,0,0,0,0,3,7,10,210,242,452
20172018,30,DAVIESS,145,Daviess County,10,Daviess County High School,30145010,210147000297,GRREC,902,737,748,1485,17,12,29,18,19,37,16,12,28,1,1,2,1,0,1,15,18,33,805,810,1615
20172018,30,DAVIESS,145,Daviess County,20,Daviess County Middle School,30145020,210147000298,GRREC,902,364,361,725,6,10,16,21,18,39,13,8,21,0,2,2,0,0,0,11,20,31,415,419,834
20172018,30,DAVIESS,145,Daviess County,40,Deer Park Elementary School,30145040,210147000301,GRREC,902,202,205,407,12,14,26,14,14,28,26,26,52,0,2,2,0,0,0,9,7,16,263,268,531
20172018,30,DAVIESS,145,Daviess County,7,East View Elementary School,30145007,210147001625,GRREC,902,206,213,419,3,1,4,27,26,53,0,0,0,2,1,3,0,0,0,13,5,18,251,246,497
20172018,30,DAVIESS,145,Daviess County,145,F T Burns Elementary School,30145145,210147000311,GRREC,902,152,166,318,16,10,26,32,25,57,14,18,32,3,4,7,3,2,5,16,18,34,236,243,479
20172018,30,DAVIESS,145,Daviess County,8,F T Burns Middle School,30145008,210147000296,GRREC,902,330,335,665,22,31,53,27,29,56,18,15,33,0,0,0,1,0,1,23,25,48,421,435,856
20172018,30,DAVIESS,145,Daviess County,180,Heritage Park High School,30145180,210147000969,GRREC,902,116,53,169,4,5,9,2,2,4,0,0,0,0,0,0,0,0,0,4,1,5,126,61,187
20172018,30,DAVIESS,145,Daviess County,25,Highland Elementary School,30145025,210147000299,GRREC,902,216,216,432,5,7,12,5,4,9,12,26,38,0,0,0,0,0,0,12,7,19,250,260,510
20172018,30,DAVIESS,145,Daviess County,6,Meadow Lands Elementary School,30145006,210147001949,GRREC,902,182,157,339,6,6,12,18,22,40,1,1,2,0,0,0,0,1,1,16,15,31,223,202,425
20172018,30,DAVIESS,145,Daviess County,160,Owensboro Day Treatment,30145160,210147000312,GRREC,902,14,6,20,0,1,1,3,1,4,0,0,0,0,0,0,0,0,0,1,2,3,18,10,28
20172018,30,DAVIESS,145,Daviess County,70,Sorgho Elementary School,30145070,210147000303,GRREC,902,177,160,337,7,4,11,20,14,34,2,0,2,0,1,1,0,0,0,11,10,21,217,189,406
20172018,30,DAVIESS,145,Daviess County,11,Southern Oaks Elementary School,30145011,210147002230,GRREC,902,161,166,327,3,3,6,27,21,48,11,17,28,0,0,0,1,2,3,3,4,7,206,213,419
20172018,30,DAVIESS,145,Daviess County,95,Tamarack Elementary School,30145095,210147000306,GRREC,902,171,157,328,23,15,38,14,19,33,5,11,16,0,0,0,1,1,2,21,11,32,235,214,449
20172018,30,DAVIESS,145,Daviess County,175,Valley Elementary School,30145175,210147000964,GRREC,902,19,11,30,3,2,5,1,1,2,0,0,0,0,0,0,0,0,0,0,0,0,23,14,37
20172018,30,DAVIESS,145,Daviess County,170,Valley High School,30145170,210147001700,GRREC,902,3,2,5,1,1,2,1,0,1,0,0,0,0,0,0,0,0,0,0,0,0,5,3,8
20172018,30,DAVIESS,145,Daviess County,130,West Louisville Elementary School,30145130,210147000309,GRREC,902,145,159,304,1,1,2,10,10,20,0,0,0,0,0,0,0,0,0,5,3,8,161,173,334
20172018,30,DAVIESS,145,Daviess County,140,Whitesville Elementary School,30145140,210147000310,GRREC,902,160,132,292,1,0,1,3,3,6,1,2,3,0,0,0,0,0,0,6,5,11,171,142,313
20172018,30,DAVIESS,145,Daviess County,,---District Total---,,,GRREC,902,4710,4500,9210,201,177,378,314,311,625,177,201,378,9,11,20,8,13,21,223,205,428,5642,5418,11060
20172018,54,HOPKINS,146,Dawson Springs Independent,17,Dawson Springs Elementary,54146017,210150002200,WKEC,908,152,140,292,1,1,2,5,3,8,0,1,1,0,0,0,1,0,1,7,3,10,166,148,314
20172018,54,HOPKINS,146,Dawson Springs Independent,18,Dawson Springs Jr/Sr High School,54146018,210150002203,WKEC,908,143,145,288,0,0,0,1,2,3,0,1,1,0,0,0,1,1,2,3,2,5,148,151,299
20172018,54,HOPKINS,146,Dawson Springs Independent,,---District Total---,,,WKEC,908,295,285,580,1,1,2,6,5,11,0,2,2,0,0,0,2,1,3,10,5,15,314,299,613
20172018,19,CAMPBELL,147,Dayton Independent,10,Dayton High School,19147010,210153000316,NKCES,905,171,158,329,8,6,14,9,6,15,0,0,0,0,0,0,0,0,0,0,2,2,188,172,360
20172018,19,CAMPBELL,147,Dayton Independent,30,Lincoln Elementary School,19147030,210153000317,NKCES,905,234,203,437,4,7,11,22,14,36,1,1,2,0,0,0,0,0,0,11,11,22,272,236,508
20172018,19,CAMPBELL,147,Dayton Independent,120,Regional Programs School,19147120,210153002413,NKCES,905,24,9,33,7,4,11,1,0,1,0,0,0,0,0,0,0,0,0,4,1,5,36,14,50
20172018,19,CAMPBELL,147,Dayton Independent,,---District Total---,,,NKCES,905,429,370,799,19,17,36,32,20,52,1,1,2,0,0,0,0,0,0,15,14,29,496,422,918
20172018,63,LAUREL,149,East Bernstadt Independent,10,East Bernstadt Elementary School,63149010,210159000318,SESC,907,220,210,430,3,4,7,1,0,1,1,2,3,0,0,0,0,0,0,0,0,0,225,216,441
20172018,63,LAUREL,149,East Bernstadt Independent,,---District Total---,,,SESC,907,220,210,430,3,4,7,1,0,1,1,2,3,0,0,0,0,0,0,0,0,0,225,216,441
20172018,31,EDMONSON,151,Edmonson County,22,Edmonson County 5/6 Center,31151022,210162001985,GRREC,902,147,116,263,0,0,0,1,6,7,0,0,0,0,0,0,0,0,0,3,4,7,151,126,277
20172018,31,EDMONSON,151,Edmonson County,60,Edmonson County High School,31151060,210162001442,GRREC,902,280,248,528,1,0,1,2,7,9,0,4,4,0,1,1,0,0,0,4,5,9,287,265,552
20172018,31,EDMONSON,151,Edmonson County,50,Edmonson County Middle School,31151050,210162000321,GRREC,902,149,144,293,0,0,0,4,4,8,2,1,3,0,1,1,0,0,0,1,4,5,156,154,310
20172018,31,EDMONSON,151,Edmonson County,23,Great Onyx Job Corps,31151023,210162002292,GRREC,902,0,0,0,0,0,0,0,0,0,0,0,0,0,0,0,0,0,0,0,0,0,0,0,0
20172018,31,EDMONSON,151,Edmonson County,80,Kyrock Elementary School,31151080,210162000322,GRREC,902,134,129,263,0,0,0,3,0,3,0,0,0,0,0,0,0,0,0,5,3,8,142,132,274
20172018,31,EDMONSON,151,Edmonson County,20,South Edmonson Elementary School,31151020,210162000319,GRREC,902,218,187,405,0,0,0,4,5,9,1,1,2,0,0,0,0,0,0,6,3,9,229,196,425
20172018,31,EDMONSON,151,Edmonson County,,---District Total---,,,GRREC,902,928,824,1752,1,0,1,14,22,36,3,6,9,0,2,2,0,0,0,19,19,38,965,873,1838
20172018,47,HARDIN,152,Elizabethtown Independent,10,Elizabethtown High School,47152010,210165000323,GRREC,902,267,263,530,40,41,81,21,25,46,11,22,33,1,2,3,1,0,1,31,19,50,372,372,744
20172018,47,HARDIN,152,Elizabethtown Independent,45,Glen Dale Center,47152045,210165002246,GRREC,902,0,16,16,0,1,1,0,0,0,0,0,0,0,0,0,0,0,0,0,0,0,0,17,17
20172018,47,HARDIN,152,Elizabethtown Independent,15,Helmwood Heights Elementary School,47152015,210165000324,GRREC,902,137,133,270,26,20,46,14,14,28,5,6,11,1,1,2,1,1,2,21,23,44,205,198,403
20172018,47,HARDIN,152,Elizabethtown Independent,20,Morningside Elementary School,47152020,210165000325,GRREC,902,162,142,304,26,26,52,20,15,35,4,4,8,0,0,0,0,1,1,25,20,45,237,208,445
20172018,47,HARDIN,152,Elizabethtown Independent,25,Panther Academy,47152025,210165002319,GRREC,902,46,43,89,12,10,22,11,4,15,2,1,3,1,0,1,0,0,0,11,10,21,83,68,151
20172018,47,HARDIN,152,Elizabethtown Independent,35,Talton K Stone Middle School,47152035,210165000326,GRREC,902,208,167,375,42,35,77,11,21,32,7,12,19,2,0,2,0,0,0,26,37,63,296,272,568
20172018,47,HARDIN,152,Elizabethtown Independent,41,Valley View Education Center,47152041,210165002355,GRREC,902,8,7,15,5,2,7,0,1,1,0,0,0,1,0,1,0,0,0,4,3,7,18,13,31
20172018,47,HARDIN,152,Elizabethtown Independent,,---District Total---,,,GRREC,902,828,771,1599,151,135,286,77,80,157,29,45,74,6,3,9,2,2,4,118,112,230,1211,1148,2359
20172018,32,ELLIOTT,155,Elliott County,280,Elliott County High School,32155280,210168000331,KEDC,903,237,243,480,1,0,1,0,0,0,0,0,0,0,1,1,0,0,0,0,0,0,238,244,482
20172018,32,ELLIOTT,155,Elliott County,140,Isonville Elementary School,32155140,210168000328,KEDC,903,47,46,93,1,0,1,0,0,0,0,0,0,0,0,0,0,0,0,0,0,0,48,46,94
20172018,32,ELLIOTT,155,Elliott County,160,Lakeside Elementary School,32155160,210168000329,KEDC,903,91,94,185,1,2,3,2,0,2,0,0,0,0,0,0,0,0,0,0,1,1,94,97,191
20172018,32,ELLIOTT,155,Elliott County,270,Sandy Hook Elementary School,32155270,210168000330,KEDC,903,148,102,250,0,0,0,2,0,2,0,0,0,0,0,0,0,0,0,0,0,0,150,102,252
20172018,32,ELLIOTT,155,Elliott County,,---District Total---,,,KEDC,903,523,485,1008,3,2,5,4,0,4,0,0,0,0,1,1,0,0,0,0,1,1,530,489,1019
20172018,52,HENRY,156,Eminence Independent,25,Bluegrass Challenge Academy,52156025,,OVEC,906,48,13,61,11,3,14,0,4,4,0,0,0,0,0,0,0,0,0,2,0,2,61,20,81
20172018,52,HENRY,156,Eminence Independent,20,Eminence Elementary School,52156020,210171000333,OVEC,906,146,137,283,8,11,19,18,13,31,0,3,3,0,2,2,0,0,0,25,19,44,197,185,382
20172018,52,HENRY,156,Eminence Independent,10,Eminence High School,52156010,210171000332,OVEC,906,173,147,320,11,9,20,26,19,45,0,0,0,0,0,0,0,0,0,16,10,26,226,185,411
20172018,52,HENRY,156,Eminence Independent,21,Whitney M. Young Jr. Job Corps Center,52156021,210171002220,OVEC,906,12,6,18,31,25,56,7,3,10,0,0,0,0,0,0,0,0,0,0,0,0,50,34,84
20172018,52,HENRY,156,Eminence Independent,,---District Total---,,,OVEC,906,379,303,682,61,48,109,51,39,90,0,3,3,0,2,2,0,0,0,43,29,72,534,424,958
20172018,59,KENTON,157,Erlanger-Elsmere Independent,5,Arnett Elementary School,59157005,210174000335,NKCES,905,119,78,197,16,6,22,12,9,21,0,2,2,0,0,0,1,0,1,12,14,26,160,109,269
20172018,59,KENTON,157,Erlanger-Elsmere Independent,61,Bartlett Educational Center,59157061,210174002313,NKCES,905,33,17,50,5,0,5,3,0,3,0,0,0,0,0,0,1,0,1,6,2,8,48,19,67
20172018,59,KENTON,157,Erlanger-Elsmere Independent,10,Howell Elementary School,59157010,210174000336,NKCES,905,106,111,217,12,9,21,15,22,37,0,0,0,0,0,0,1,0,1,20,19,39,154,161,315
20172018,59,KENTON,157,Erlanger-Elsmere Independent,3,Lindeman Elementary School,59157003,210174000334,NKCES,905,115,86,201,14,15,29,26,25,51,1,2,3,0,0,0,5,5,10,16,20,36,177,153,330
20172018,59,KENTON,157,Erlanger-Elsmere Independent,30,Lloyd High School,59157030,210174000337,NKCES,905,214,194,408,36,34,70,41,32,73,1,3,4,0,0,0,1,2,3,31,21,52,324,286,610
20172018,59,KENTON,157,Erlanger-Elsmere Independent,50,Miles Elementary School,59157050,210174000338,NKCES,905,97,101,198,5,6,11,10,17,27,0,0,0,0,0,0,0,0,0,17,14,31,129,138,267
20172018,59,KENTON,157,Erlanger-Elsmere Independent,60,Tichenor Middle School,59157060,210174000339,NKCES,905,208,170,378,18,19,37,20,21,41,0,1,1,1,1,2,1,2,3,27,31,58,275,245,520
20172018,59,KENTON,157,Erlanger-Elsmere Independent,,---District Total---,,,NKCES,905,892,757,1649,106,89,195,127,126,253,2,8,10,1,1,2,10,9,19,129,121,250,1267,1111,2378
20172018,33,ESTILL,161,Estill County,90,Estill County High School,33161090,210176000342,SESC,907,342,318,660,0,1,1,1,4,5,1,2,3,0,0,0,0,0,0,5,4,9,349,329,678
20172018,33,ESTILL,161,Estill County,85,Estill County Middle School,33161085,210176000341,SESC,907,273,237,510,0,0,0,1,2,3,2,0,2,0,0,0,0,0,0,2,1,3,278,240,518
20172018,33,ESTILL,161,Estill County,14,Estill County Success Academy,33161014,210176002406,SESC,907,15,4,19,0,0,0,0,0,0,0,0,0,0,0,0,0,0,0,0,0,0,15,4,19
20172018,33,ESTILL,161,Estill County,11,Estill Springs Elementary,33161011,210176001746,SESC,907,229,211,440,1,0,1,1,3,4,0,0,0,0,0,0,0,0,0,7,0,7,238,214,452
20172018,33,ESTILL,161,Estill County,280,West Irvine Intermediate,33161280,210176000346,SESC,907,263,265,528,0,1,1,2,2,4,1,1,2,0,0,0,0,0,0,2,5,7,268,274,542
20172018,33,ESTILL,161,Estill County,,---District Total---,,,SESC,907,1122,1035,2157,1,2,3,5,11,16,4,3,7,0,0,0,0,0,0,16,10,26,1148,1061,2209
20172018,10,BOYD,162,Fairview Independent,11,Fairview Elementary School,10162011,210180001889,KEDC,903,158,131,289,2,2,4,0,1,1,0,0,0,1,0,1,0,0,0,2,4,6,163,138,301
20172018,10,BOYD,162,Fairview Independent,20,Fairview High School,10162020,210180000348,KEDC,903,193,197,390,5,1,6,3,0,3,1,1,2,0,0,0,0,0,0,4,6,10,206,205,411
20172018,10,BOYD,162,Fairview Independent,,---District Total---,,,KEDC,903,351,328,679,7,3,10,3,1,4,1,1,2,1,0,1,0,0,0,6,10,16,369,343,712
20172018,34,FAYETTE,165,Fayette County,51,ABLE,34165051,210186002236,CKEC,901,11,1,12,6,2,8,1,1,2,1,1,2,0,0,0,0,0,0,1,1,2,20,6,26
20172018,34,FAYETTE,165,Fayette County,5,Arlington Elementary School,34165005,210186000350,CKEC,901,36,43,79,43,39,82,50,66,116,0,0,0,0,0,0,0,0,0,8,9,17,137,157,294
20172018,34,FAYETTE,165,Fayette County,7,Ashland Elementary School,34165007,210186000351,CKEC,901,123,86,209,31,37,68,5,9,14,0,3,3,0,0,0,0,0,0,4,14,18,163,149,312
20172018,34,FAYETTE,165,Fayette County,45,Athens-Chilesburg Elementary,34165045,210186001987,CKEC,901,291,278,569,30,46,76,16,14,30,38,34,72,2,1,3,0,0,0,16,20,36,393,393,786
20172018,34,FAYETTE,165,Fayette County,651,Audrey Grevious Center,34165651,210186001480,CKEC,901,7,2,9,16,4,20,5,1,6,0,0,0,0,0,0,0,0,0,2,1,3,30,8,38
20172018,34,FAYETTE,165,Fayette County,15,Beaumont Middle School,34165015,210186000353,CKEC,901,340,299,639,36,33,69,112,90,202,46,51,97,1,0,1,1,0,1,17,21,38,553,494,1047
20172018,34,FAYETTE,165,Fayette County,55,Booker T Washington Elementary School,34165055,,CKEC,901,4,10,14,60,63,123,62,57,119,0,1,1,0,1,1,0,0,0,9,9,18,135,141,276
20172018,34,FAYETTE,165,Fayette County,170,Bryan Station High School,34165170,210186000388,CKEC,901,280,268,548,239,255,494,179,164,343,4,6,10,0,2,2,0,0,0,23,28,51,725,723,1448
20172018,34,FAYETTE,165,Fayette County,30,Bryan Station Middle School,34165030,210186000358,CKEC,901,180,168,348,70,95,165,88,93,181,3,5,8,1,0,1,0,0,0,25,18,43,367,379,746
20172018,34,FAYETTE,165,Fayette County,240,Cardinal Valley Elementary School,34165240,210186000392,CKEC,901,24,40,64,37,30,67,218,210,428,0,0,0,2,0,2,0,0,0,6,3,9,287,283,570
20172018,34,FAYETTE,165,Fayette County,275,Carter G. Woodson Academy,34165275,210186002323,CKEC,901,3,0,3,167,0,167,25,0,25,1,0,1,0,0,0,0,0,0,12,0,12,208,0,208
20172018,34,FAYETTE,165,Fayette County,32,Cassidy Elementary School,34165032,210186000359,CKEC,901,254,274,528,32,23,55,31,21,52,24,25,49,1,1,2,1,0,1,22,16,38,365,360,725
20172018,34,FAYETTE,165,Fayette County,120,Clays Mill Elementary School,34165120,210186000384,CKEC,901,263,226,489,12,6,18,17,20,37,12,4,16,1,0,1,0,0,0,20,13,33,325,269,594
20172018,34,FAYETTE,165,Fayette County,98,Coventry Oak Elementary,34165098,,CKEC,901,68,68,136,100,86,186,112,92,204,3,1,4,1,0,1,0,0,0,12,20,32,296,267,563
20172018,34,FAYETTE,165,Fayette County,25,Crawford Middle School,34165025,210186000357,CKEC,901,84,102,186,126,141,267,89,73,162,4,10,14,2,0,2,0,0,0,16,15,31,321,341,662
20172018,34,FAYETTE,165,Fayette County,35,Deep Springs Elementary School,34165035,210186000360,CKEC,901,95,96,191,104,65,169,59,46,105,0,0,0,1,0,1,0,0,0,18,20,38,277,227,504
20172018,34,FAYETTE,165,Fayette County,36,Dixie Elementary Magnet School,34165036,210186000361,CKEC,901,144,114,258,81,79,160,41,33,74,4,3,7,1,1,2,0,0,0,22,18,40,293,248,541
20172018,34,FAYETTE,165,Fayette County,905,Eastside Technical Center,34165905,210186001564,CKEC,901,0,0,0,0,0,0,0,0,0,0,0,0,0,0,0,0,0,0,0,0,0,0,0,0
20172018,34,FAYETTE,165,Fayette County,34,Edythe Jones Hayes Middle School,34165034,210186001957,CKEC,901,338,343,681,93,96,189,31,34,65,54,32,86,2,1,3,0,1,1,37,37,74,555,544,1099
20172018,34,FAYETTE,165,Fayette County,66,Family Care Center,34165066,210186002325,CKEC,901,0,6,6,0,9,9,0,20,20,0,0,0,0,0,0,0,0,0,0,2,2,0,37,37
20172018,34,FAYETTE,165,Fayette County,898,Fayette County Learning Center,34165898,210186002251,CKEC,901,65,55,120,15,14,29,6,5,11,0,0,0,0,0,0,0,0,0,10,1,11,96,75,171
20172018,34,FAYETTE,165,Fayette County,102,Fayette Regional Juvenile Det Ctr,34165102,210186002025,CKEC,901,17,7,24,19,4,23,1,0,1,0,0,0,0,0,0,0,0,0,0,0,0,37,11,48
20172018,34,FAYETTE,165,Fayette County,125,Frederick Douglass High School,34165125,,CKEC,901,193,220,413,172,175,347,68,60,128,17,14,31,2,1,3,0,0,0,22,21,43,474,491,965
20172018,34,FAYETTE,165,Fayette County,37,Garden Springs Elementary School,34165037,210186000362,CKEC,901,168,157,325,12,14,26,40,27,67,4,5,9,0,0,0,0,0,0,11,16,27,235,219,454
20172018,34,FAYETTE,165,Fayette County,99,Garrett Morgan Elementary,34165099,,CKEC,901,241,218,459,72,56,128,21,15,36,39,31,70,1,0,1,2,0,2,28,18,46,404,338,742
20172018,34,FAYETTE,165,Fayette County,150,Glendover Elementary School,34165150,210186000386,CKEC,901,157,163,320,23,26,49,66,61,127,37,28,65,0,0,0,0,0,0,8,11,19,291,289,580
20172018,34,FAYETTE,165,Fayette County,38,Harrison Elementary School,34165038,210186000363,CKEC,901,31,34,65,79,70,149,15,21,36,2,1,3,1,0,1,0,0,0,10,7,17,138,133,271
20172018,34,FAYETTE,165,Fayette County,39,Henry Clay High School,34165039,210186000364,CKEC,901,639,655,1294,187,241,428,115,76,191,68,70,138,4,4,8,1,1,2,50,30,80,1064,1077,2141
20172018,34,FAYETTE,165,Fayette County,190,James Lane Allen Elementary School,34165190,210186000390,CKEC,901,58,64,122,36,29,65,119,110,229,2,2,4,0,0,0,0,0,0,10,6,16,225,211,436
20172018,34,FAYETTE,165,Fayette County,225,Jessie M Clark Middle School,34165225,210186000391,CKEC,901,388,378,766,51,40,91,39,40,79,38,36,74,0,2,2,0,0,0,19,15,34,535,511,1046
20172018,34,FAYETTE,165,Fayette County,620,Julius Marks Elementary School,34165620,210186000395,CKEC,901,159,142,301,99,89,188,33,32,65,17,10,27,0,0,0,1,1,2,30,42,72,339,316,655
20172018,34,FAYETTE,165,Fayette County,60,Lafayette High School,34165060,210186000367,CKEC,901,756,754,1510,136,146,282,100,102,202,45,76,121,0,0,0,4,0,4,26,43,69,1067,1121,2188
20172018,34,FAYETTE,165,Fayette County,62,Lansdowne Elementary School,34165062,210186000368,CKEC,901,170,127,297,93,65,158,44,36,80,15,10,25,1,0,1,0,0,0,25,19,44,348,257,605
20172018,34,FAYETTE,165,Fayette County,65,Leestown Middle School,34165065,210186000369,CKEC,901,168,130,298,97,103,200,160,137,297,5,8,13,0,1,1,0,0,0,20,24,44,450,403,853
20172018,34,FAYETTE,165,Fayette County,67,Lexington Trad Magnet School,34165067,210186000370,CKEC,901,68,58,126,125,123,248,56,34,90,7,2,9,0,0,0,0,1,1,22,12,34,278,230,508
20172018,34,FAYETTE,165,Fayette County,57,Liberty Elementary,34165057,210186002207,CKEC,901,221,191,412,76,61,137,29,50,79,19,15,34,0,0,0,0,3,3,28,28,56,373,348,721
20172018,34,FAYETTE,165,Fayette County,68,Locust Trace AgriScience Center,34165068,210186002362,CKEC,901,0,0,0,0,0,0,0,0,0,0,0,0,0,0,0,0,0,0,0,0,0,0,0,0
20172018,34,FAYETTE,165,Fayette County,72,Madeline M Breckinridge Elem School,34165072,210186000372,CKEC,901,52,54,106,121,119,240,77,78,155,15,8,23,0,0,0,1,0,1,17,25,42,283,284,567
20172018,34,FAYETTE,165,Fayette County,21,Martin L King Acad for Excellence Alt,34165021,210186001848,CKEC,901,51,24,75,69,38,107,17,6,23,0,0,0,0,0,0,0,0,0,8,6,14,145,74,219
20172018,34,FAYETTE,165,Fayette County,180,Mary Todd Elementary School,34165180,210186000389,CKEC,901,64,58,122,69,73,142,94,86,180,1,0,1,0,0,0,0,0,0,12,7,19,240,224,464
20172018,34,FAYETTE,165,Fayette County,74,Maxwell Spanish Immersion Elem School,34165074,210186000373,CKEC,901,129,147,276,51,46,97,45,49,94,7,3,10,0,1,1,0,0,0,22,35,57,254,281,535
20172018,34,FAYETTE,165,Fayette County,160,Meadowthorpe Elementary School,34165160,210186000387,CKEC,901,131,108,239,46,48,94,41,34,75,13,9,22,1,0,1,0,1,1,17,18,35,249,218,467
20172018,34,FAYETTE,165,Fayette County,255,Millcreek Elementary School,34165255,210186001419,CKEC,901,112,79,191,95,79,174,28,29,57,3,6,9,0,0,0,0,0,0,23,28,51,261,221,482
20172018,34,FAYETTE,165,Fayette County,76,Morton Middle School,34165076,210186000374,CKEC,901,249,231,480,36,56,92,43,38,81,24,20,44,0,0,0,0,1,1,13,14,27,365,360,725
20172018,34,FAYETTE,165,Fayette County,77,Northern Elementary School,34165077,210186000375,CKEC,901,72,57,129,111,102,213,68,66,134,0,0,0,0,1,1,0,0,0,6,5,11,257,231,488
20172018,34,FAYETTE,165,Fayette County,899,Opportunity Middle College,34165899,210186002242,CKEC,901,8,34,42,6,27,33,4,13,17,1,3,4,0,0,0,0,0,0,1,3,4,20,80,100
20172018,34,FAYETTE,165,Fayette County,200,Paul Laurence Dunbar High School,34165200,210186001669,CKEC,901,519,524,1043,125,123,248,240,219,459,85,89,174,0,3,3,1,1,2,27,21,48,997,980,1977
20172018,34,FAYETTE,165,Fayette County,80,Picadome Elementary School,34165080,210186000376,CKEC,901,134,123,257,74,61,135,19,19,38,10,10,20,0,0,0,0,0,0,10,18,28,247,231,478
20172018,34,FAYETTE,165,Fayette County,52,Rosa Parks Elementary School,34165052,210186001422,CKEC,901,237,207,444,10,10,20,14,7,21,101,99,200,1,3,4,0,0,0,10,15,25,373,341,714
20172018,34,FAYETTE,165,Fayette County,90,Russell Cave Elementary School,34165090,210186000380,CKEC,901,16,13,29,9,8,17,103,96,199,0,0,0,0,0,0,0,0,0,3,0,3,131,117,248
20172018,34,FAYETTE,165,Fayette County,111,SAP Program,34165111,,CKEC,901,0,0,0,0,0,0,0,0,0,0,0,0,0,0,0,0,0,0,0,0,0,0,0,0
20172018,34,FAYETTE,165,Fayette County,130,STEAM Academy,34165130,210186002341,CKEC,901,85,62,147,33,40,73,8,9,17,5,3,8,0,1,1,0,1,1,5,3,8,136,119,255
20172018,34,FAYETTE,165,Fayette County,58,Sandersville Elementary,34165058,210186002189,CKEC,901,153,145,298,73,77,150,37,40,77,4,6,10,2,2,4,0,0,0,13,20,33,282,290,572
20172018,34,FAYETTE,165,Fayette County,18,Scapa At Bluegrass,34165018,210186000354,CKEC,901,68,136,204,2,17,19,1,8,9,4,20,24,0,0,0,0,0,0,3,17,20,78,198,276
20172018,34,FAYETTE,165,Fayette County,81,Southern Elementary School,34165081,210186000377,CKEC,901,118,127,245,75,87,162,34,31,65,4,6,10,2,0,2,0,0,0,18,23,41,251,274,525
20172018,34,FAYETTE,165,Fayette County,525,Southern Middle School,34165525,210186000394,CKEC,901,269,206,475,72,99,171,42,34,76,11,10,21,0,2,2,1,0,1,24,19,43,419,370,789
20172018,34,FAYETTE,165,Fayette County,904,Southside Technical Center,34165904,210186001563,CKEC,901,0,0,0,0,0,0,0,0,0,0,0,0,0,0,0,0,0,0,0,0,0,0,0,0
20172018,34,FAYETTE,165,Fayette County,82,Squires Elementary School,34165082,210186001584,CKEC,901,159,157,316,54,61,115,29,29,58,7,13,20,0,1,1,0,0,0,8,11,19,257,272,529
20172018,34,FAYETTE,165,Fayette County,85,Stonewall Elementary School,34165085,210186000378,CKEC,901,265,267,532,26,23,49,18,28,46,21,22,43,0,0,0,0,0,0,14,25,39,344,365,709
20172018,34,FAYETTE,165,Fayette County,133,Success Academy,34165133,,CKEC,901,0,0,0,0,0,0,0,0,0,0,0,0,0,0,0,0,0,0,0,0,0,0,0,0
20172018,34,FAYETTE,165,Fayette County,95,Tates Creek Elementary School,34165095,210186000381,CKEC,901,124,118,242,118,125,243,32,29,61,8,6,14,0,4,4,0,0,0,30,31,61,312,313,625
20172018,34,FAYETTE,165,Fayette County,105,Tates Creek High School,34165105,210186000383,CKEC,901,493,497,990,257,255,512,86,72,158,21,22,43,0,1,1,0,0,0,33,47,80,890,894,1784
20172018,34,FAYETTE,165,Fayette County,100,Tates Creek Middle School,34165100,210186000382,CKEC,901,246,171,417,108,132,240,48,34,82,16,13,29,0,1,1,1,1,2,35,33,68,454,385,839
20172018,34,FAYETTE,165,Fayette County,135,The Newcomer Academy,34165135,,CKEC,901,0,0,0,0,0,0,0,0,0,0,0,0,0,0,0,0,0,0,0,0,0,0,0,0
20172018,34,FAYETTE,165,Fayette County,54,The Stables,34165054,210186002320,CKEC,901,25,19,44,3,4,7,0,0,0,0,0,0,0,1,1,0,0,0,0,1,1,28,25,53
20172018,34,FAYETTE,165,Fayette County,12,Veterans Park Elementary School,34165012,210186001421,CKEC,901,323,294,617,37,34,71,19,14,33,25,20,45,0,1,1,0,0,0,15,14,29,419,377,796
20172018,34,FAYETTE,165,Fayette County,59,Wellington Elementary,34165059,210186002247,CKEC,901,239,239,478,12,26,38,25,25,50,44,47,91,1,1,2,0,0,0,34,30,64,355,368,723
20172018,34,FAYETTE,165,Fayette County,56,William Wells Brown Elementary,34165056,210186002199,CKEC,901,16,20,36,95,117,212,14,28,42,0,0,0,0,0,0,0,0,0,8,9,17,133,174,307
20172018,34,FAYETTE,165,Fayette County,245,Winburn Middle School,34165245,210186000393,CKEC,901,65,79,144,109,123,232,113,113,226,16,14,30,1,1,2,0,0,0,8,12,20,312,342,654
20172018,34,FAYETTE,165,Fayette County,140,Yates Elementary School,34165140,210186000385,CKEC,901,55,49,104,61,63,124,46,60,106,2,0,2,0,0,0,0,0,0,8,3,11,172,175,347
20172018,34,FAYETTE,165,Fayette County,,---District Total---,,,CKEC,901,10525,10029,20554,4532,4438,8970,3398,3144,6542,957,933,1890,32,39,71,14,12,26,1014,1052,2066,20472,19647,40119
20172018,35,FLEMING,171,Fleming County,50,E P Ward Elementary School,35171050,210192000400,KEDC,903,82,83,165,1,0,1,3,1,4,0,0,0,0,0,0,0,0,0,1,0,1,87,84,171
20172018,35,FLEMING,171,Fleming County,20,Ewing Elementary School,35171020,210192000396,KEDC,903,147,128,275,2,0,2,5,4,9,0,0,0,0,0,0,0,0,0,0,5,5,154,137,291
20172018,35,FLEMING,171,Fleming County,35,Fleming County High School,35171035,210192000398,KEDC,903,349,323,672,4,5,9,10,3,13,0,4,4,0,1,1,0,0,0,1,8,9,364,344,708
20172018,35,FLEMING,171,Fleming County,40,Flemingsburg Elementary School,35171040,210192000399,KEDC,903,261,230,491,4,1,5,11,13,24,2,0,2,0,0,0,0,0,0,5,7,12,283,251,534
20172018,35,FLEMING,171,Fleming County,60,Hillsboro Elementary School,35171060,210192000401,KEDC,903,80,82,162,0,0,0,1,2,3,0,0,0,0,0,0,0,0,0,1,4,5,82,88,170
20172018,35,FLEMING,171,Fleming County,30,Simons Middle School,35171030,210192000397,KEDC,903,153,148,301,4,2,6,7,5,12,2,1,3,0,0,0,0,0,0,1,6,7,167,162,329
20172018,35,FLEMING,171,Fleming County,,---District Total---,,,KEDC,903,1072,994,2066,15,8,23,37,28,65,4,5,9,0,1,1,0,0,0,9,30,39,1137,1066,2203
20172018,36,FLOYD,175,Floyd County,20,Allen Elementary School,36175020,210195000403,KVEC,904,233,229,462,4,2,6,6,3,9,1,0,1,0,0,0,0,0,0,2,2,4,246,236,482
20172018,36,FLOYD,175,Floyd County,120,Betsy Layne Elementary School,36175120,210195000407,KVEC,904,306,283,589,0,1,1,2,1,3,1,0,1,0,0,0,0,0,0,6,6,12,315,291,606
20172018,36,FLOYD,175,Floyd County,110,Betsy Layne High School,36175110,210195000406,KVEC,904,206,193,399,0,0,0,1,1,2,1,0,1,0,0,0,0,0,0,2,1,3,210,195,405
20172018,36,FLOYD,175,Floyd County,10,Duff-Allen Central Elementary,36175010,,KVEC,904,284,315,599,1,1,2,2,2,4,0,0,0,0,0,0,0,0,0,1,0,1,288,318,606
20172018,36,FLOYD,175,Floyd County,115,Floyd Central High School,36175115,,KVEC,904,343,314,657,2,0,2,1,0,1,0,0,0,0,0,0,0,0,0,1,3,4,347,317,664
20172018,36,FLOYD,175,Floyd County,440,James D. Adams Middle School,36175440,210195001670,KVEC,904,182,140,322,0,1,1,5,2,7,0,0,0,0,0,0,1,0,1,0,2,2,188,145,333
20172018,36,FLOYD,175,Floyd County,485,John M. Stumbo Elementary School,36175485,210195000415,KVEC,904,151,127,278,0,0,0,1,1,2,0,0,0,0,0,0,0,0,0,2,2,4,154,130,284
20172018,36,FLOYD,175,Floyd County,21,May Valley Elementary School,36175021,210195001426,KVEC,904,159,151,310,2,0,2,0,2,2,0,0,0,0,0,0,0,0,0,0,0,0,161,153,314
20172018,36,FLOYD,175,Floyd County,19,Prestonsburg Elementary School,36175019,210195002210,KVEC,904,346,297,643,0,1,1,8,5,13,1,0,1,1,0,1,0,0,0,4,5,9,360,308,668
20172018,36,FLOYD,175,Floyd County,850,Prestonsburg High School,36175850,210195000423,KVEC,904,261,216,477,0,1,1,0,1,1,0,1,1,1,0,1,0,0,0,0,0,0,262,219,481
20172018,36,FLOYD,175,Floyd County,50,Renaissance Learning Center,36175050,210195001004,KVEC,904,0,0,0,0,0,0,0,0,0,0,0,0,0,0,0,0,0,0,0,0,0,0,0,0
20172018,36,FLOYD,175,Floyd County,30,South Floyd Elementary School,36175030,,KVEC,904,379,302,681,4,2,6,2,4,6,0,0,0,0,0,0,0,0,0,1,2,3,386,310,696
20172018,36,FLOYD,175,Floyd County,,---District Total---,,,KVEC,904,2859,2570,5429,13,9,22,28,22,50,4,1,5,2,0,2,1,0,1,21,23,44,2928,2625,5553
20172018,19,CAMPBELL,176,Fort Thomas Independent,10,Highlands High School,19176010,210204000428,NKCES,905,446,502,948,6,5,11,8,10,18,8,11,19,0,0,0,1,0,1,6,6,12,475,534,1009
20172018,19,CAMPBELL,176,Fort Thomas Independent,11,Highlands Middle School,19176011,210204001400,NKCES,905,369,313,682,4,1,5,10,7,17,1,6,7,0,0,0,0,0,0,25,13,38,409,340,749
20172018,19,CAMPBELL,176,Fort Thomas Independent,20,Johnson Elementary School,19176020,210204000429,NKCES,905,202,187,389,0,2,2,3,1,4,0,2,2,1,0,1,0,0,0,8,3,11,214,195,409
20172018,19,CAMPBELL,176,Fort Thomas Independent,30,Moyer Elementary School,19176030,210204000430,NKCES,905,243,226,469,6,3,9,9,10,19,5,10,15,0,1,1,0,0,0,11,16,27,274,266,540
20172018,19,CAMPBELL,176,Fort Thomas Independent,40,Woodfill Elementary School,19176040,210204000431,NKCES,905,182,157,339,4,2,6,4,3,7,2,1,3,0,0,0,0,0,0,12,8,20,204,171,375
20172018,19,CAMPBELL,176,Fort Thomas Independent,,---District Total---,,,NKCES,905,1442,1385,2827,20,13,33,34,31,65,16,30,46,1,1,2,1,0,1,62,46,108,1576,1506,3082
20172018,37,FRANKLIN,177,Frankfort Independent,70,Frankfort High School,37177070,210198000433,CKEC,901,90,60,150,19,20,39,1,3,4,1,1,2,0,0,0,0,0,0,14,6,20,125,90,215
20172018,37,FRANKLIN,177,Frankfort Independent,80,REP Academy,37177080,210198001524,CKEC,901,10,2,12,5,1,6,0,0,0,0,0,0,0,0,0,0,0,0,5,1,6,20,4,24
20172018,37,FRANKLIN,177,Frankfort Independent,50,Second Street School,37177050,210198000432,CKEC,901,184,195,379,47,39,86,12,9,21,0,0,0,0,0,0,0,0,0,22,33,55,265,276,541
20172018,37,FRANKLIN,177,Frankfort Independent,,---District Total---,,,CKEC,901,284,257,541,71,60,131,13,12,25,1,1,2,0,0,0,0,0,0,41,40,81,410,370,780
20172018,37,FRANKLIN,181,Franklin County,15,Bondurant Middle School,37181015,210201000435,OVEC,906,297,253,550,27,15,42,15,17,32,11,12,23,0,2,2,0,0,0,29,24,53,379,323,702
20172018,37,FRANKLIN,181,Franklin County,14,Bridgeport Elementary School,37181014,210201001990,OVEC,906,174,158,332,14,16,30,9,8,17,10,9,19,0,0,0,0,0,0,11,11,22,218,202,420
20172018,37,FRANKLIN,181,Franklin County,25,Collins Lane,37181025,210201000437,OVEC,906,175,177,352,17,13,30,30,27,57,5,16,21,1,1,2,0,0,0,20,14,34,248,248,496
20172018,37,FRANKLIN,181,Franklin County,16,Early Learning Village,37181016,210201002219,OVEC,906,70,74,144,15,23,38,8,4,12,1,0,1,0,0,0,0,0,0,13,14,27,107,115,222
20172018,37,FRANKLIN,181,Franklin County,35,Elkhorn Elementary School,37181035,210201000439,OVEC,906,148,111,259,45,38,83,31,26,57,2,2,4,0,0,0,0,0,0,23,21,44,249,198,447
20172018,37,FRANKLIN,181,Franklin County,30,Elkhorn Middle School,37181030,210201000438,OVEC,906,257,274,531,45,46,91,34,23,57,6,8,14,0,0,0,0,0,0,34,28,62,376,379,755
20172018,37,FRANKLIN,181,Franklin County,12,Franklin County Career and Technical Ctr,37181012,210201002055,OVEC,906,0,0,0,0,0,0,0,0,0,0,0,0,0,0,0,0,0,0,0,0,0,0,0,0
20172018,37,FRANKLIN,181,Franklin County,40,Franklin County High School,37181040,210201000440,OVEC,906,341,339,680,60,59,119,57,41,98,11,19,30,0,0,0,0,0,0,17,29,46,486,487,973
20172018,37,FRANKLIN,181,Franklin County,45,Hearn Elementary,37181045,210201000441,OVEC,906,170,139,309,33,29,62,16,23,39,6,8,14,1,2,3,0,0,0,26,26,52,252,227,479
20172018,37,FRANKLIN,181,Franklin County,50,Peaks Mill Elementary,37181050,210201000442,OVEC,906,180,144,324,25,23,48,8,15,23,1,1,2,0,0,0,0,0,0,18,14,32,232,197,429
20172018,37,FRANKLIN,181,Franklin County,420,Rosenwald Center for Early Dev,37181420,,OVEC,906,0,0,0,0,0,0,0,0,0,0,0,0,0,0,0,0,0,0,0,0,0,0,0,0
20172018,37,FRANKLIN,181,Franklin County,11,The Academy,37181011,210201001917,OVEC,906,28,7,35,5,0,5,0,0,0,0,0,0,0,0,0,0,0,0,7,1,8,40,8,48
20172018,37,FRANKLIN,181,Franklin County,70,Western Hills High School,37181070,210201001420,OVEC,906,326,348,674,19,19,38,22,14,36,7,15,22,1,0,1,0,0,0,18,12,30,393,408,801
20172018,37,FRANKLIN,181,Franklin County,13,Westridge Elementary,37181013,210201001989,OVEC,906,162,159,321,8,15,23,6,4,10,5,1,6,4,1,5,0,0,0,10,10,20,195,190,385
20172018,37,FRANKLIN,181,Franklin County,,---District Total---,,,OVEC,906,2328,2183,4511,313,296,609,236,202,438,65,91,156,7,6,13,0,0,0,226,204,430,3175,2982,6157
20172018,38,FULTON,185,Fulton County,20,Fulton County Elementary,38185020,210210002113,WKEC,908,111,107,218,64,59,123,4,5,9,0,0,0,2,1,3,0,0,0,13,16,29,194,188,382
20172018,38,FULTON,185,Fulton County,30,Fulton County High School,38185030,210210000445,WKEC,908,56,59,115,24,23,47,2,2,4,1,0,1,0,0,0,0,0,0,4,1,5,87,85,172
20172018,38,FULTON,185,Fulton County,15,Fulton County Middle School,38185015,,WKEC,908,0,0,0,0,0,0,0,0,0,0,0,0,0,0,0,0,0,0,0,0,0,0,0,0
20172018,38,FULTON,185,Fulton County,,---District Total---,,,WKEC,908,167,166,333,88,82,170,6,7,13,1,0,1,2,1,3,0,0,0,17,17,34,281,273,554
20172018,38,FULTON,186,Fulton Independent,18,Fulton Independent School,38186018,210207002205,WKEC,908,76,63,139,62,69,131,6,1,7,0,2,2,1,0,1,0,0,0,28,24,52,173,159,332
20172018,38,FULTON,186,Fulton Independent,,---District Total---,,,WKEC,908,76,63,139,62,69,131,6,1,7,0,2,2,1,0,1,0,0,0,28,24,52,173,159,332
20172018,39,GALLATIN,191,Gallatin County,20,Gallatin County High School,39191020,210213000451,OVEC,906,206,188,394,0,1,1,31,21,52,1,0,1,0,0,0,0,1,1,8,9,17,246,220,466
20172018,39,GALLATIN,191,Gallatin County,10,Gallatin County Lower Elementary,39191010,210213000450,OVEC,906,149,147,296,1,1,2,20,14,34,1,0,1,1,1,2,0,0,0,3,3,6,175,166,341
20172018,39,GALLATIN,191,Gallatin County,5,Gallatin County Middle School,39191005,210213001609,OVEC,906,164,180,344,3,0,3,20,16,36,0,0,0,0,0,0,0,0,0,6,5,11,193,201,394
20172018,39,GALLATIN,191,Gallatin County,6,Gallatin County Upper Elementary,39191006,210213001850,OVEC,906,135,144,279,2,4,6,16,17,33,1,0,1,0,0,0,1,0,1,4,5,9,159,170,329
20172018,39,GALLATIN,191,Gallatin County,,---District Total---,,,OVEC,906,654,659,1313,6,6,12,87,68,155,3,0,3,1,1,2,1,1,2,21,22,43,773,757,1530
20172018,40,GARRARD,195,Garrard County,50,Camp Dick Robinson Elementary School,40195050,210216000454,SESC,907,235,226,461,2,3,5,10,6,16,0,3,3,0,0,0,0,0,0,5,4,9,252,242,494
20172018,40,GARRARD,195,Garrard County,60,Garrard County High School,40195060,210216000455,SESC,907,348,337,685,3,5,8,22,9,31,1,3,4,0,0,0,0,0,0,14,10,24,388,364,752
20172018,40,GARRARD,195,Garrard County,70,Garrard Middle School,40195070,210216001672,SESC,907,251,247,498,8,4,12,19,22,41,3,2,5,1,1,2,0,0,0,2,12,14,284,288,572
20172018,40,GARRARD,195,Garrard County,220,Lancaster Elementary School,40195220,210216000457,SESC,907,193,148,341,13,8,21,13,6,19,1,0,1,0,0,0,0,0,0,11,11,22,231,173,404
20172018,40,GARRARD,195,Garrard County,90,Paint Lick Elementary School,40195090,210216000456,SESC,907,151,113,264,1,1,2,10,7,17,0,0,0,0,0,0,0,0,0,3,6,9,165,127,292
20172018,40,GARRARD,195,Garrard County,,---District Total---,,,SESC,907,1178,1071,2249,27,21,48,74,50,124,5,8,13,1,1,2,0,0,0,35,43,78,1320,1194,2514
20172018,5,BARREN,197,Glasgow Independent,30,Glasgow High School,5197030,210222000461,GRREC,902,191,203,394,49,36,85,36,22,58,7,4,11,0,0,0,0,0,0,19,14,33,302,279,581
20172018,5,BARREN,197,Glasgow Independent,35,Glasgow Middle School,5197035,210222000402,GRREC,902,172,151,323,28,25,53,22,19,41,6,2,8,0,0,0,0,0,0,19,17,36,247,214,461
20172018,5,BARREN,197,Glasgow Independent,15,Happy Valley Learning Center,5197015,210222002101,GRREC,902,7,2,9,5,0,5,1,0,1,0,0,0,0,0,0,0,0,0,1,2,3,14,4,18
20172018,5,BARREN,197,Glasgow Independent,13,Highland Elementary School,5197013,210222001991,GRREC,902,197,198,395,26,35,61,45,34,79,0,5,5,2,2,4,2,2,4,21,27,48,293,303,596
20172018,5,BARREN,197,Glasgow Independent,65,South Green Elementary School,5197065,210222001565,GRREC,902,139,134,273,17,34,51,32,41,73,1,2,3,0,0,0,0,0,0,17,30,47,206,241,447
20172018,5,BARREN,197,Glasgow Independent,2,Success Academy,5197002,210222002215,GRREC,902,23,33,56,4,3,7,11,4,15,0,0,0,0,0,0,0,0,0,2,2,4,40,42,82
20172018,5,BARREN,197,Glasgow Independent,,---District Total---,,,GRREC,902,729,721,1450,129,133,262,147,120,267,14,13,27,2,2,4,2,2,4,79,92,171,1102,1083,2185
20172018,41,GRANT,201,Grant County,20,Crittenden-Mt. Zion Elementary,41201020,210225000465,OVEC,906,232,251,483,2,1,3,5,9,14,0,2,2,0,0,0,1,0,1,6,12,18,246,275,521
20172018,41,GRANT,201,Grant County,30,Dry Ridge Elementary,41201030,210225000466,OVEC,906,203,197,400,5,0,5,7,7,14,1,4,5,2,0,2,0,0,0,12,8,20,230,216,446
20172018,41,GRANT,201,Grant County,40,Grant County High School,41201040,210225000467,OVEC,906,515,468,983,2,2,4,23,21,44,2,2,4,1,1,2,0,0,0,9,12,21,552,506,1058
20172018,41,GRANT,201,Grant County,80,Grant County Middle School,41201080,210225000469,OVEC,906,379,413,792,1,2,3,21,19,40,0,0,0,0,1,1,0,0,0,12,12,24,413,447,860
20172018,41,GRANT,201,Grant County,50,Mason-Corinth Elementary,41201050,210225001701,OVEC,906,156,159,315,0,1,1,4,2,6,1,0,1,0,0,0,0,0,0,0,1,1,161,163,324
20172018,41,GRANT,201,Grant County,16,Sherman Elementary,41201016,210225002201,OVEC,906,184,184,368,0,2,2,23,20,43,0,0,0,0,1,1,2,0,2,7,11,18,216,218,434
20172018,41,GRANT,201,Grant County,,---District Total---,,,OVEC,906,1669,1672,3341,10,8,18,83,78,161,4,8,12,3,3,6,3,0,3,46,56,102,1818,1825,3643
20172018,42,GRAVES,205,Graves County,40,Fancy Farm Elementary School,42205040,210228000471,WKEC,908,105,79,184,0,0,0,1,1,2,0,0,0,0,0,0,0,0,0,5,7,12,111,87,198
20172018,42,GRAVES,205,Graves County,60,Farmington Elementary School,42205060,210228000473,WKEC,908,112,116,228,3,1,4,7,4,11,0,1,1,0,0,0,0,0,0,8,4,12,130,126,256
20172018,42,GRAVES,205,Graves County,12,Gateway Academy High School,42205012,210228001924,WKEC,908,28,30,58,3,0,3,1,1,2,1,0,1,0,0,0,0,0,0,2,2,4,35,33,68
20172018,42,GRAVES,205,Graves County,13,Graves County Central Elementary,42205013,210228001992,WKEC,908,179,195,374,6,1,7,23,22,45,0,3,3,0,0,0,0,0,0,13,13,26,221,234,455
20172018,42,GRAVES,205,Graves County,215,Graves County High School,42205215,210228001490,WKEC,908,531,547,1078,9,9,18,38,36,74,2,4,6,1,1,2,0,0,0,15,19,34,596,616,1212
20172018,42,GRAVES,205,Graves County,100,Graves County Middle School,42205100,210228001436,WKEC,908,253,271,524,0,4,4,17,21,38,3,1,4,0,0,0,0,0,0,12,7,19,285,304,589
20172018,42,GRAVES,205,Graves County,110,Lowes Elementary School,42205110,210228000475,WKEC,908,111,75,186,5,4,9,18,23,41,0,1,1,0,0,0,0,0,0,2,2,4,136,105,241
20172018,42,GRAVES,205,Graves County,11,Mayfield Youth Development Center,42205011,210228001754,WKEC,908,11,0,11,3,0,3,1,0,1,0,0,0,0,0,0,0,0,0,1,0,1,16,0,16
20172018,42,GRAVES,205,Graves County,150,Sedalia Elementary School,42205150,210228000477,WKEC,908,148,146,294,0,3,3,14,9,23,2,0,2,0,0,0,0,0,0,14,7,21,178,165,343
20172018,42,GRAVES,205,Graves County,170,Symsonia Elementary School,42205170,210228000479,WKEC,908,142,125,267,1,2,3,3,5,8,0,1,1,1,1,2,0,0,0,3,5,8,150,139,289
20172018,42,GRAVES,205,Graves County,200,Wingo Elementary School,42205200,210228000481,WKEC,908,195,162,357,3,1,4,12,9,21,1,1,2,0,1,1,0,0,0,10,11,21,221,185,406
20172018,42,GRAVES,205,Graves County,,---District Total---,,,WKEC,908,1815,1746,3561,33,25,58,135,131,266,9,12,21,2,3,5,0,0,0,85,77,162,2079,1994,4073
20172018,43,GRAYSON,211,Grayson County,30,Caneyville Elementary School,43211030,210230000484,GRREC,902,184,158,342,1,0,1,0,1,1,0,0,0,0,0,0,0,0,0,3,1,4,188,160,348
20172018,43,GRAYSON,211,Grayson County,80,Clarkson Elementary School,43211080,210230000485,GRREC,902,309,275,584,2,1,3,6,4,10,0,0,0,0,0,0,0,0,0,6,6,12,323,286,609
20172018,43,GRAYSON,211,Grayson County,220,Grayson Co. Alternative Education,43211220,210230001852,GRREC,902,0,0,0,0,0,0,0,0,0,0,0,0,0,0,0,0,0,0,0,0,0,0,0,0
20172018,43,GRAYSON,211,Grayson County,908,Grayson County Area Vocational Ed Center,43211908,210230002381,GRREC,902,0,0,0,0,0,0,0,0,0,0,0,0,0,0,0,0,0,0,0,0,0,0,0,0
20172018,43,GRAYSON,211,Grayson County,85,Grayson County High School,43211085,210230000486,GRREC,902,630,589,1219,6,5,11,14,12,26,1,3,4,0,0,0,0,0,0,10,11,21,661,620,1281
20172018,43,GRAYSON,211,Grayson County,95,Grayson County Middle School,43211095,210230000487,GRREC,902,507,426,933,5,3,8,12,10,22,0,1,1,1,1,2,0,0,0,8,11,19,533,452,985
20172018,43,GRAYSON,211,Grayson County,10,H W Wilkey Elementary School,43211010,210230000483,GRREC,902,233,192,425,2,3,5,10,6,16,3,1,4,1,2,3,0,0,0,1,4,5,250,208,458
20172018,43,GRAYSON,211,Grayson County,50,Oran P Lawler Elementary School,43211050,210230001702,GRREC,902,197,180,377,3,0,3,6,3,9,4,1,5,2,0,2,0,0,0,4,8,12,216,192,408
20172018,43,GRAYSON,211,Grayson County,,---District Total---,,,GRREC,902,2060,1820,3880,19,12,31,48,36,84,8,6,14,4,3,7,0,0,0,32,41,73,2171,1918,4089
20172018,44,GREEN,215,Green County,65,Green County High School,44215065,210234000490,GRREC,902,246,211,457,7,4,11,4,2,6,2,1,3,1,0,1,0,0,0,4,11,15,264,229,493
20172018,44,GREEN,215,Green County,40,Green County Intermediate School,44215040,210234002257,GRREC,902,175,166,341,3,4,7,8,5,13,1,1,2,0,0,0,0,0,0,9,6,15,196,182,378
20172018,44,GREEN,215,Green County,55,Green County Middle School,44215055,210234001526,GRREC,902,158,166,324,6,3,9,5,3,8,1,0,1,0,0,0,0,0,0,9,4,13,179,176,355
20172018,44,GREEN,215,Green County,30,Green County Primary School,44215030,210234002244,GRREC,902,163,154,317,3,1,4,7,5,12,0,0,0,0,0,0,0,0,0,10,5,15,183,165,348
20172018,44,GREEN,215,Green County,,---District Total---,,,GRREC,902,742,697,1439,19,12,31,24,15,39,4,2,6,1,0,1,0,0,0,32,26,58,822,752,1574
20172018,45,GREENUP,221,Greenup County,10,Argillite Elementary School,45221010,210240000493,KEDC,903,129,106,235,0,1,1,1,3,4,0,0,0,0,0,0,0,0,0,2,3,5,132,113,245
20172018,45,GREENUP,221,Greenup County,27,Greenup County High School,45221027,210240000496,KEDC,903,414,342,756,4,1,5,6,5,11,0,1,1,2,2,4,0,0,0,2,2,4,428,353,781
20172018,45,GREENUP,221,Greenup County,40,Greysbranch Elementary School,45221040,210240000497,KEDC,903,168,159,327,2,2,4,2,2,4,1,0,1,0,0,0,0,0,0,3,1,4,176,164,340
20172018,45,GREENUP,221,Greenup County,60,Mckell Elementary School,45221060,210240000499,KEDC,903,221,206,427,1,0,1,6,2,8,1,0,1,0,1,1,0,0,0,7,5,12,236,214,450
20172018,45,GREENUP,221,Greenup County,105,Mckell Middle School,45221105,210240001611,KEDC,903,186,176,362,0,0,0,0,2,2,0,0,0,0,0,0,0,0,0,4,2,6,190,180,370
20172018,45,GREENUP,221,Greenup County,110,Wurtland Elementary School,45221110,210240000504,KEDC,903,101,93,194,2,3,5,3,1,4,0,0,0,0,0,0,0,0,0,3,3,6,109,100,209
20172018,45,GREENUP,221,Greenup County,24,Wurtland Middle School,45221024,210240001610,KEDC,903,165,152,317,1,1,2,1,3,4,0,1,1,0,0,0,0,0,0,3,4,7,170,161,331
20172018,45,GREENUP,221,Greenup County,,---District Total---,,,KEDC,903,1384,1234,2618,10,8,18,19,18,37,2,2,4,2,3,5,0,0,0,24,20,44,1441,1285,2726
20172018,46,HANCOCK,225,Hancock County,5,Hancock County High School,46225005,210246000507,GRREC,902,258,225,483,2,2,4,8,5,13,3,5,8,0,0,0,0,0,0,4,5,9,275,242,517
20172018,46,HANCOCK,225,Hancock County,7,Hancock County Middle School,46225007,210246000508,GRREC,902,209,166,375,1,0,1,4,10,14,1,2,3,0,0,0,0,0,0,4,5,9,219,183,402
20172018,46,HANCOCK,225,Hancock County,6,North Hancock Elementary School,46225006,210246001993,GRREC,902,264,207,471,3,1,4,5,8,13,0,4,4,0,0,0,0,0,0,6,5,11,278,225,503
20172018,46,HANCOCK,225,Hancock County,70,South Hancock Elementary School,46225070,210246000511,GRREC,902,120,87,207,1,2,3,0,1,1,0,1,1,0,0,0,0,0,0,3,0,3,124,91,215
20172018,46,HANCOCK,225,Hancock County,,---District Total---,,,GRREC,902,851,685,1536,7,5,12,17,24,41,4,12,16,0,0,0,0,0,0,17,15,32,896,741,1637
20172018,47,HARDIN,231,Hardin County,15,Bluegrass Middle School,47231015,210249001673,GRREC,902,173,147,320,62,46,108,22,19,41,12,4,16,0,1,1,3,3,6,24,26,50,296,246,542
20172018,47,HARDIN,231,Hardin County,30,Cecilia Valley Elementary School,47231030,210249000514,GRREC,902,129,124,253,4,3,7,9,5,14,0,0,0,0,0,0,0,0,0,7,5,12,149,137,286
20172018,47,HARDIN,231,Hardin County,190,Central Hardin High School,47231190,210249000528,GRREC,902,830,756,1586,35,32,67,35,42,77,7,13,20,2,4,6,3,2,5,27,30,57,939,879,1818
20172018,47,HARDIN,231,Hardin County,25,College View Campus,47231025,,GRREC,902,82,49,131,34,12,46,9,7,16,0,1,1,1,0,1,2,3,5,8,4,12,136,76,212
20172018,47,HARDIN,231,Hardin County,185,Communicare ARC,47231185,,GRREC,902,0,0,0,0,0,0,0,0,0,0,0,0,0,0,0,0,0,0,0,0,0,0,0,0
20172018,47,HARDIN,231,Hardin County,17,Creekside Elementary School,47231017,210249001994,GRREC,902,203,185,388,6,2,8,8,6,14,0,1,1,1,1,2,0,0,0,11,8,19,229,203,432
20172018,47,HARDIN,231,Hardin County,976,Crossroads Treatment Center,47231976,210249002269,GRREC,902,9,0,9,1,0,1,0,0,0,0,0,0,0,0,0,0,0,0,0,0,0,10,0,10
20172018,47,HARDIN,231,Hardin County,70,Early College and Career Center,47231070,210249002373,GRREC,902,0,0,0,0,0,0,0,0,0,0,0,0,0,0,0,0,0,0,0,0,0,0,0,0
20172018,47,HARDIN,231,Hardin County,5,East Hardin Middle School,47231005,210249000512,GRREC,902,356,358,714,12,8,20,22,19,41,2,0,2,0,1,1,0,0,0,11,18,29,403,404,807
20172018,47,HARDIN,231,Hardin County,20,G C Burkhead Elementary School,47231020,210249000513,GRREC,902,259,235,494,33,26,59,31,46,77,6,6,12,1,1,2,0,0,0,26,23,49,356,337,693
20172018,47,HARDIN,231,Hardin County,180,Hardin County Day Treatment Center,47231180,210249000656,GRREC,902,5,2,7,3,2,5,0,0,0,0,0,0,0,1,1,0,0,0,4,0,4,12,5,17
20172018,47,HARDIN,231,Hardin County,18,Heartland Elementary School,47231018,210249002209,GRREC,902,209,183,392,34,37,71,25,29,54,9,7,16,0,0,0,1,1,2,28,26,54,306,283,589
20172018,47,HARDIN,231,Hardin County,77,James T Alton Middle School,47231077,210249000518,GRREC,902,223,191,414,55,53,108,26,40,66,7,6,13,0,2,2,4,3,7,32,20,52,347,315,662
20172018,47,HARDIN,231,Hardin County,13,John Hardin High School,47231013,210249001910,GRREC,902,247,225,472,103,94,197,33,51,84,8,13,21,2,2,4,2,2,4,33,31,64,428,418,846
20172018,47,HARDIN,231,Hardin County,14,Lakewood Elementary School,47231014,210249001963,GRREC,902,257,215,472,6,2,8,14,10,24,2,1,3,1,0,1,0,0,0,3,6,9,283,234,517
20172018,47,HARDIN,231,Hardin County,979,Lincoln Trail Behavioral Health Systems,47231979,210249002249,GRREC,902,0,24,24,0,4,4,0,0,0,0,0,0,0,0,0,0,0,0,0,0,0,0,28,28
20172018,47,HARDIN,231,Hardin County,50,Lincoln Trail Elementary School,47231050,210249000515,GRREC,902,230,216,446,3,7,10,6,5,11,0,5,5,0,3,3,0,0,0,7,21,28,246,257,503
20172018,47,HARDIN,231,Hardin County,210,Meadow View Elementary School,47231210,210249001566,GRREC,902,110,85,195,74,92,166,28,34,62,1,3,4,0,0,0,4,2,6,43,29,72,260,245,505
20172018,47,HARDIN,231,Hardin County,40,New Highland Elementary School,47231040,210249001446,GRREC,902,124,106,230,35,43,78,18,38,56,5,4,9,3,0,3,1,6,7,27,35,62,213,232,445
20172018,47,HARDIN,231,Hardin County,75,North Hardin High School,47231075,210249000517,GRREC,902,388,399,787,215,215,430,73,68,141,19,12,31,1,3,4,11,11,22,42,60,102,749,768,1517
20172018,47,HARDIN,231,Hardin County,80,North Middle School,47231080,210249000520,GRREC,902,136,117,253,102,101,203,40,39,79,4,6,10,0,0,0,2,4,6,43,40,83,327,307,634
20172018,47,HARDIN,231,Hardin County,21,North Park Elementary School,47231021,210249002297,GRREC,902,87,84,171,31,38,69,22,20,42,1,1,2,0,1,1,0,3,3,21,25,46,162,172,334
20172018,47,HARDIN,231,Hardin County,79,Radcliff Elementary  School,47231079,210249000519,GRREC,902,114,110,224,60,52,112,43,30,73,2,3,5,2,2,4,2,2,4,28,46,74,251,245,496
20172018,47,HARDIN,231,Hardin County,90,Rineyville Elementary School,47231090,210249000521,GRREC,902,226,231,457,18,19,37,18,18,36,0,1,1,0,0,0,1,2,3,20,21,41,283,292,575
20172018,47,HARDIN,231,Hardin County,982,Spectrum Care Academy,47231982,210249002248,GRREC,902,7,0,7,0,0,0,0,0,0,0,0,0,0,0,0,0,0,0,0,0,0,7,0,7
20172018,47,HARDIN,231,Hardin County,165,Vine Grove Elementary School,47231165,210249000524,GRREC,902,161,182,343,30,25,55,23,23,46,2,2,4,0,0,0,2,4,6,35,21,56,253,257,510
20172018,47,HARDIN,231,Hardin County,168,West Hardin Middle School,47231168,210249000525,GRREC,902,237,240,477,12,14,26,14,11,25,4,1,5,0,0,0,0,1,1,17,15,32,284,282,566
20172018,47,HARDIN,231,Hardin County,8,Woodland Elementary School,47231008,210249001471,GRREC,902,129,100,229,91,76,167,37,29,66,3,1,4,0,0,0,2,0,2,38,43,81,300,249,549
20172018,47,HARDIN,231,Hardin County,,---District Total---,,,GRREC,902,4931,4564,9495,1059,1003,2062,556,589,1145,94,91,185,14,22,36,40,49,89,535,553,1088,7229,6871,14100
20172018,48,HARLAN,235,Harlan County,60,Black Mountain Elementary School,48235060,210254000532,SESC,907,156,146,302,3,3,6,2,3,5,0,0,0,0,0,0,0,0,0,4,6,10,165,158,323
20172018,48,HARLAN,235,Harlan County,110,Cawood Elementary School,48235110,210254000534,SESC,907,119,123,242,0,0,0,0,2,2,0,0,0,0,0,0,0,0,0,0,0,0,119,125,244
20172018,48,HARLAN,235,Harlan County,195,Cumberland Elementary School,48235195,210254000091,SESC,907,256,240,496,12,14,26,6,6,12,0,0,0,0,0,0,0,0,0,2,3,5,276,263,539
20172018,48,HARLAN,235,Harlan County,290,Evarts Elementary School,48235290,210254000539,SESC,907,175,178,353,3,2,5,5,4,9,0,0,0,0,0,0,0,0,0,0,3,3,183,187,370
20172018,48,HARLAN,235,Harlan County,325,Green Hills Elementary School,48235325,210254000540,SESC,907,66,64,130,0,0,0,0,0,0,0,0,0,0,0,0,0,0,0,0,0,0,66,64,130
20172018,48,HARLAN,235,Harlan County,25,Harlan County High School,48235025,210254002213,SESC,907,481,484,965,15,8,23,10,4,14,0,2,2,0,0,0,1,0,1,3,3,6,510,501,1011
20172018,48,HARLAN,235,Harlan County,340,James A. Cawood Elementary,48235340,210254000541,SESC,907,165,166,331,6,6,12,4,5,9,0,0,0,0,0,0,0,0,0,1,0,1,176,177,353
20172018,48,HARLAN,235,Harlan County,540,Rosspoint Elementary School,48235540,210254000545,SESC,907,191,185,376,2,1,3,1,1,2,0,0,0,0,1,1,0,0,0,3,1,4,197,189,386
20172018,48,HARLAN,235,Harlan County,640,Wallins Elementary School,48235640,210254000549,SESC,907,201,209,410,0,1,1,3,2,5,0,0,0,1,0,1,0,0,0,0,0,0,205,212,417
20172018,48,HARLAN,235,Harlan County,,---District Total---,,,SESC,907,1810,1795,3605,41,35,76,31,27,58,0,2,2,1,1,2,1,0,1,13,16,29,1897,1876,3773
20172018,48,HARLAN,236,Harlan Independent,20,Harlan Elementary School,48236020,210252000551,SESC,907,112,119,231,4,4,8,2,1,3,0,1,1,0,0,0,0,0,0,8,11,19,126,136,262
20172018,48,HARLAN,236,Harlan Independent,30,Harlan High School,48236030,210252000552,SESC,907,191,166,357,12,10,22,4,2,6,3,5,8,1,0,1,0,0,0,4,8,12,215,191,406
20172018,48,HARLAN,236,Harlan Independent,,---District Total---,,,SESC,907,303,285,588,16,14,30,6,3,9,3,6,9,1,0,1,0,0,0,12,19,31,341,327,668
20172018,49,HARRISON,241,Harrison County,35,Eastside Elementary School,49241035,210258000553,CKEC,901,176,155,331,2,2,4,2,3,5,1,1,2,0,0,0,0,0,0,4,7,11,185,168,353
20172018,49,HARRISON,241,Harrison County,40,Harrison County High School,49241040,210258000555,CKEC,901,414,354,768,9,10,19,13,15,28,1,2,3,0,1,1,0,0,0,6,4,10,443,386,829
20172018,49,HARRISON,241,Harrison County,37,Harrison County Learning Center,49241037,210258001995,CKEC,901,27,17,44,1,0,1,3,0,3,0,0,0,0,0,0,1,0,1,0,1,1,32,18,50
20172018,49,HARRISON,241,Harrison County,43,Harrison County Middle School,49241043,210258000556,CKEC,901,313,301,614,3,4,7,10,15,25,1,1,2,1,1,2,0,0,0,8,3,11,336,325,661
20172018,49,HARRISON,241,Harrison County,45,Northside Elementary School,49241045,210258000557,CKEC,901,140,133,273,4,2,6,8,11,19,1,0,1,1,0,1,0,0,0,9,3,12,163,149,312
20172018,49,HARRISON,241,Harrison County,38,Southside Elementary School,49241038,210258000554,CKEC,901,128,154,282,1,1,2,12,9,21,0,2,2,1,0,1,0,0,0,6,5,11,148,171,319
20172018,49,HARRISON,241,Harrison County,75,Westside Elementary School,49241075,210258000558,CKEC,901,135,138,273,1,3,4,3,8,11,0,0,0,0,0,0,0,0,0,4,4,8,143,153,296
20172018,49,HARRISON,241,Harrison County,,---District Total---,,,CKEC,901,1333,1252,2585,21,22,43,51,61,112,4,6,10,3,2,5,1,0,1,37,27,64,1450,1370,2820
20172018,50,HART,245,Hart County,10,Bonnieville Elementary School,50245010,210264000562,GRREC,902,146,142,288,1,0,1,1,4,5,0,0,0,0,0,0,0,0,0,0,0,0,148,146,294
20172018,50,HART,245,Hart County,30,Cub Run Elementary School,50245030,210264000563,GRREC,902,102,109,211,0,0,0,2,3,5,0,0,0,0,0,0,0,0,0,0,4,4,104,116,220
20172018,50,HART,245,Hart County,45,Hart County High School,50245045,210264000564,GRREC,902,315,313,628,12,8,20,5,5,10,0,0,0,1,0,1,0,0,0,3,6,9,336,332,668
20172018,50,HART,245,Hart County,50,Legrande Elementary School,50245050,210264000565,GRREC,902,125,142,267,1,1,2,3,5,8,0,0,0,0,0,0,0,0,0,2,3,5,131,151,282
20172018,50,HART,245,Hart County,70,Memorial Elementary School,50245070,210264000566,GRREC,902,153,158,311,1,2,3,1,8,9,0,0,0,0,0,0,0,0,0,7,2,9,162,170,332
20172018,50,HART,245,Hart County,90,Munfordville Elementary School,50245090,210264000567,GRREC,902,204,210,414,10,11,21,12,16,28,0,1,1,0,0,0,0,0,0,11,10,21,237,248,485
20172018,50,HART,245,Hart County,,---District Total---,,,GRREC,902,1045,1074,2119,25,22,47,24,41,65,0,1,1,1,0,1,0,0,0,23,25,48,1118,1163,2281
20172018,97,PERRY,246,Hazard Independent,10,Hazard High School,97246010,210267000568,KVEC,904,144,137,281,9,14,23,0,3,3,5,3,8,0,0,0,0,0,0,5,9,14,163,166,329
20172018,97,PERRY,246,Hazard Independent,45,Hazard Middle School,97246045,210267000569,KVEC,904,110,96,206,5,7,12,1,2,3,1,3,4,1,1,2,1,0,1,10,6,16,129,115,244
20172018,97,PERRY,246,Hazard Independent,60,Roy G. Eversole Elementary School,97246060,210267000570,KVEC,904,180,152,332,13,8,21,2,4,6,0,3,3,0,1,1,0,1,1,14,6,20,209,175,384
20172018,97,PERRY,246,Hazard Independent,,---District Total---,,,KVEC,904,434,385,819,27,29,56,3,9,12,6,9,15,1,2,3,1,1,2,29,21,50,501,456,957
20172018,51,HENDERSON,251,Henderson County,30,A B Chandler Elementary School,51251030,210271000573,WKEC,908,146,107,253,9,4,13,10,7,17,0,0,0,0,0,0,0,1,1,21,13,34,186,132,318
20172018,51,HENDERSON,251,Henderson County,10,Bend Gate Elementary School,51251010,210271000571,WKEC,908,162,172,334,47,27,74,15,12,27,5,5,10,0,0,0,0,0,0,26,18,44,255,234,489
20172018,51,HENDERSON,251,Henderson County,20,Cairo Elementary School,51251020,210271000572,WKEC,908,122,143,265,2,5,7,4,4,8,1,1,2,0,0,0,0,0,0,13,11,24,142,164,306
20172018,51,HENDERSON,251,Henderson County,33,East Heights Elementary School,51251033,210271000574,WKEC,908,217,228,445,25,16,41,10,10,20,1,0,1,0,0,0,0,0,0,26,19,45,279,273,552
20172018,51,HENDERSON,251,Henderson County,60,Henderson County High School,51251060,210271000577,WKEC,908,814,793,1607,79,84,163,45,39,84,4,10,14,0,0,0,2,2,4,48,52,100,992,980,1972
20172018,51,HENDERSON,251,Henderson County,65,Henderson County North Middle School,51251065,210271000578,WKEC,908,317,350,667,20,32,52,11,15,26,0,0,0,1,1,2,1,0,1,23,23,46,373,421,794
20172018,51,HENDERSON,251,Henderson County,150,Henderson County South Middle School,51251150,210271000585,WKEC,908,294,293,587,37,50,87,14,15,29,0,2,2,1,1,2,3,6,9,34,27,61,383,394,777
20172018,51,HENDERSON,251,Henderson County,160,Jefferson Elementary School,51251160,210271000586,WKEC,908,111,95,206,28,27,55,21,23,44,1,1,2,0,0,0,6,3,9,28,17,45,195,166,361
20172018,51,HENDERSON,251,Henderson County,70,Niagara Elementary School,51251070,210271000579,WKEC,908,127,152,279,0,1,1,1,1,2,0,0,0,0,0,0,0,0,0,2,7,9,130,161,291
20172018,51,HENDERSON,251,Henderson County,91,South Heights Elementary School,51251091,210271000581,WKEC,908,172,156,328,42,45,87,27,16,43,0,0,0,0,0,0,0,0,0,35,30,65,276,247,523
20172018,51,HENDERSON,251,Henderson County,110,Spottsville Elementary School,51251110,210271000583,WKEC,908,190,205,395,10,7,17,1,6,7,0,0,0,0,0,0,1,0,1,9,10,19,211,228,439
20172018,51,HENDERSON,251,Henderson County,15,The Central Academy,51251015,,WKEC,908,82,79,161,19,9,28,1,1,2,0,0,0,0,1,1,0,0,0,13,8,21,115,98,213
20172018,51,HENDERSON,251,Henderson County,,---District Total---,,,WKEC,908,2754,2773,5527,318,307,625,160,149,309,12,19,31,2,3,5,13,12,25,278,235,513,3537,3498,7035
20172018,52,HENRY,255,Henry County,10,Campbellsburg Elementary School,52255010,210276000588,OVEC,906,164,152,316,3,0,3,8,4,12,0,1,1,0,0,0,0,0,0,2,3,5,177,160,337
20172018,52,HENRY,255,Henry County,20,Eastern Elementary School,52255020,210276000589,OVEC,906,83,97,180,0,0,0,3,7,10,0,0,0,0,0,0,0,0,0,3,4,7,89,108,197
20172018,52,HENRY,255,Henry County,35,Henry County High School,52255035,210276000590,OVEC,906,312,324,636,11,4,15,19,15,34,1,2,3,0,1,1,0,0,0,5,5,10,348,351,699
20172018,52,HENRY,255,Henry County,38,Henry County Middle School,52255038,210276000591,OVEC,906,218,202,420,3,0,3,8,10,18,1,1,2,1,1,2,0,0,0,6,3,9,237,217,454
20172018,52,HENRY,255,Henry County,40,New Castle Elementary School,52255040,210276000592,OVEC,906,176,152,328,1,4,5,8,12,20,0,0,0,0,1,1,0,0,0,8,9,17,193,178,371
20172018,52,HENRY,255,Henry County,,---District Total---,,,OVEC,906,953,927,1880,18,8,26,46,48,94,2,4,6,1,3,4,0,0,0,24,24,48,1044,1014,2058
20172018,53,HICKMAN,261,Hickman County,20,Hickman County Elementary School,53261020,210279000593,WKEC,908,134,154,288,16,15,31,7,8,15,0,1,1,2,0,2,0,0,0,22,11,33,181,189,370
20172018,53,HICKMAN,261,Hickman County,50,Hickman County High School,53261050,210279000594,WKEC,908,132,133,265,12,17,29,5,3,8,0,0,0,0,0,0,0,0,0,7,7,14,156,160,316
20172018,53,HICKMAN,261,Hickman County,,---District Total---,,,WKEC,908,266,287,553,28,32,60,12,11,23,0,1,1,2,0,2,0,0,0,29,18,47,337,349,686
20172018,54,HOPKINS,265,Hopkins County,140,Browning Springs Middle School,54265140,210286000601,WKEC,908,141,160,301,37,26,63,16,13,29,0,2,2,0,0,0,0,0,0,15,27,42,209,228,437
20172018,54,HOPKINS,265,Hopkins County,330,Earlington Elementary School,54265330,210286000614,WKEC,908,143,117,260,10,10,20,12,10,22,0,0,0,0,0,0,0,0,0,16,17,33,181,154,335
20172018,54,HOPKINS,265,Hopkins County,90,Grapevine Elementary School,54265090,210286000598,WKEC,908,96,104,200,18,10,28,13,10,23,0,0,0,0,0,0,1,0,1,14,12,26,142,136,278
20172018,54,HOPKINS,265,Hopkins County,110,Hanson Elementary School,54265110,210286000600,WKEC,908,241,233,474,16,15,31,4,8,12,3,5,8,0,0,0,1,0,1,16,9,25,281,270,551
20172018,54,HOPKINS,265,Hopkins County,105,Hopkins Co Career & Technology Center,54265105,,WKEC,908,0,0,0,0,0,0,0,0,0,0,0,0,0,0,0,0,0,0,0,0,0,0,0,0
20172018,54,HOPKINS,265,Hopkins County,130,Hopkins County Central High School,54265130,210286001473,WKEC,908,389,327,716,27,29,56,21,10,31,1,3,4,3,1,4,0,1,1,12,6,18,453,377,830
20172018,54,HOPKINS,265,Hopkins County,5,Hopkins County Day Treatment,54265005,210286001586,WKEC,908,15,1,16,2,1,3,1,1,2,0,0,0,0,0,0,0,0,0,0,0,0,18,3,21
20172018,54,HOPKINS,265,Hopkins County,4,Hopkins County Schools Academy,54265004,210286002280,WKEC,908,32,23,55,3,4,7,4,2,6,0,0,0,0,0,0,0,0,0,2,1,3,41,30,71
20172018,54,HOPKINS,265,Hopkins County,75,James Madison Middle School,54265075,210286000681,WKEC,908,221,215,436,28,25,53,10,10,20,2,2,4,0,0,0,1,2,3,19,13,32,281,267,548
20172018,54,HOPKINS,265,Hopkins County,20,Jesse Stuart Elementary School,54265020,210286000673,WKEC,908,150,180,330,38,32,70,9,14,23,1,3,4,0,0,0,1,1,2,20,23,43,219,253,472
20172018,54,HOPKINS,265,Hopkins County,145,Madisonville North Hopkins High School,54265145,210286000602,WKEC,908,403,360,763,47,62,109,25,18,43,5,9,14,0,0,0,1,1,2,19,23,42,500,473,973
20172018,54,HOPKINS,265,Hopkins County,200,Pride Elementary School,54265200,210286000606,WKEC,908,129,135,264,29,39,68,7,10,17,0,0,0,1,1,2,0,0,0,27,21,48,193,206,399
20172018,54,HOPKINS,265,Hopkins County,185,South Hopkins Middle School,54265185,210286001499,WKEC,908,169,165,334,12,7,19,7,12,19,0,0,0,1,0,1,0,0,0,11,11,22,200,195,395
20172018,54,HOPKINS,265,Hopkins County,280,Southside Elementary School,54265280,210286000474,WKEC,908,203,180,383,1,1,2,5,5,10,0,2,2,0,0,0,2,0,2,14,5,19,225,193,418
20172018,54,HOPKINS,265,Hopkins County,250,West Broadway Elementary School,54265250,210286000611,WKEC,908,145,131,276,20,19,39,6,6,12,0,1,1,0,0,0,0,0,0,17,18,35,188,175,363
20172018,54,HOPKINS,265,Hopkins County,6,West Hopkins School,54265006,210286001472,WKEC,908,221,164,385,1,0,1,5,4,9,0,0,0,0,1,1,0,0,0,2,6,8,229,175,404
20172018,54,HOPKINS,265,Hopkins County,,---District Total---,,,WKEC,908,2698,2495,5193,289,280,569,145,133,278,12,27,39,5,3,8,7,5,12,204,192,396,3360,3135,6495
20172018,55,JACKSON,271,Jackson County,29,Barnabus Home High School,55271029,210294002390,SESC,907,6,0,6,1,0,1,1,0,1,0,0,0,0,0,0,0,0,0,0,0,0,8,0,8
20172018,55,JACKSON,271,Jackson County,27,Barnabus Home Middle School,55271027,210294002375,SESC,907,7,0,7,0,0,0,0,0,0,0,0,0,0,0,0,0,0,0,0,0,0,7,0,7
20172018,55,JACKSON,271,Jackson County,20,Jackson County High School,55271020,210294000615,SESC,907,302,274,576,0,0,0,2,0,2,0,1,1,2,0,2,0,0,0,0,1,1,306,276,582
20172018,55,JACKSON,271,Jackson County,25,Jackson County Middle School,55271025,210294001674,SESC,907,247,197,444,0,0,0,1,1,2,0,1,1,0,0,0,0,0,0,0,0,0,248,199,447
20172018,55,JACKSON,271,Jackson County,180,McKee Elementary School,55271180,210294000617,SESC,907,149,137,286,1,0,1,2,3,5,0,0,0,0,0,0,0,0,0,2,0,2,154,140,294
20172018,55,JACKSON,271,Jackson County,280,Sand Gap Elementary School,55271280,210294000619,SESC,907,125,100,225,0,0,0,1,0,1,0,0,0,0,0,0,0,0,0,0,0,0,126,100,226
20172018,55,JACKSON,271,Jackson County,340,Tyner Elementary School,55271340,210294000620,SESC,907,216,221,437,0,2,2,2,3,5,0,1,1,0,0,0,0,0,0,0,1,1,218,228,446
20172018,55,JACKSON,271,Jackson County,,---District Total---,,,SESC,907,1052,929,1981,2,2,4,9,7,16,0,3,3,2,0,2,0,0,0,2,2,4,1067,943,2010
20172018,13,BREATHITT,272,Jackson Independent,11,Jackson City School,13272011,210291001719,KVEC,904,152,162,314,0,0,0,0,0,0,4,2,6,0,0,0,0,0,0,0,0,0,156,164,320
20172018,13,BREATHITT,272,Jackson Independent,,---District Total---,,,KVEC,904,152,162,314,0,0,0,0,0,0,4,2,6,0,0,0,0,0,0,0,0,0,156,164,320
20172018,56,JEFFERSON,275,Jefferson County,456,Ackerly,56275456,210299001859,,909,3,6,9,0,2,2,1,0,1,0,0,0,0,0,0,0,0,0,0,0,0,4,8,12
20172018,56,JEFFERSON,275,Jefferson County,920,Ahrens Educational Resource Center,56275920,210299001447,,909,9,8,17,11,5,16,1,0,1,0,0,0,0,0,0,0,0,0,2,0,2,23,13,36
20172018,56,JEFFERSON,275,Jefferson County,175,Alex R. Kennedy Elementary,56275175,210299002421,,909,60,39,99,47,32,79,17,12,29,5,7,12,0,0,0,0,0,0,12,5,17,141,95,236
20172018,56,JEFFERSON,275,Jefferson County,18,Atherton High,56275018,210299000632,,909,399,546,945,121,157,278,43,61,104,26,31,57,0,0,0,0,0,0,15,28,43,604,823,1427
20172018,56,JEFFERSON,275,Jefferson County,185,Atkinson Academy,56275185,210299000733,,909,71,67,138,110,112,222,5,5,10,2,1,3,0,0,0,0,0,0,16,10,26,204,195,399
20172018,56,JEFFERSON,275,Jefferson County,127,Auburndale Elementary,56275127,210299000707,,909,140,123,263,72,53,125,52,55,107,27,28,55,0,0,0,2,1,3,10,11,21,303,271,574
20172018,56,JEFFERSON,275,Jefferson County,44,Audubon Traditional Elementary,56275044,210299000643,,909,197,174,371,81,87,168,14,4,18,4,6,10,0,1,1,0,0,0,15,25,40,311,297,608
20172018,56,JEFFERSON,275,Jefferson County,105,Ballard High,56275105,210299000695,,909,427,581,1008,288,290,578,38,51,89,31,51,82,3,1,4,4,2,6,34,31,65,825,1007,1832
20172018,56,JEFFERSON,275,Jefferson County,40,Barret Traditional Middle,56275040,210299000641,,909,205,222,427,65,71,136,12,22,34,8,18,26,0,0,0,0,0,0,6,8,14,296,341,637
20172018,56,JEFFERSON,275,Jefferson County,55,Bates Elementary,56275055,210299000650,,909,157,189,346,58,42,100,23,29,52,6,10,16,0,0,0,0,0,0,19,17,36,263,287,550
20172018,56,JEFFERSON,275,Jefferson County,220,Bellewood,56275220,210299002394,,909,25,10,35,11,0,11,1,1,2,0,0,0,0,0,0,0,0,0,3,1,4,40,12,52
20172018,56,JEFFERSON,275,Jefferson County,183,Binet School,56275183,210299000732,,909,17,7,24,24,6,30,2,0,2,0,2,2,0,0,0,0,0,0,2,0,2,45,15,60
20172018,56,JEFFERSON,275,Jefferson County,149,Blake Elementary,56275149,210299000719,,909,107,92,199,75,63,138,49,47,96,5,3,8,1,0,1,0,0,0,30,15,45,267,220,487
20172018,56,JEFFERSON,275,Jefferson County,225,Bloom Elementary,56275225,210299000737,,909,190,205,395,43,39,82,10,9,19,2,2,4,1,0,1,0,0,0,21,18,39,267,273,540
20172018,56,JEFFERSON,275,Jefferson County,91,Blue Lick Elementary,56275091,210299000683,,909,149,133,282,57,68,125,29,24,53,2,0,2,0,0,0,0,0,0,14,16,30,251,241,492
20172018,56,JEFFERSON,275,Jefferson County,94,Bowen Elementary,56275094,210299000685,,909,225,180,405,41,35,76,74,60,134,20,30,50,0,0,0,0,2,2,28,19,47,388,326,714
20172018,56,JEFFERSON,275,Jefferson County,28,Boys & Girls Haven,56275028,210299001475,,909,17,6,23,6,0,6,2,0,2,0,0,0,0,0,0,0,0,0,6,1,7,31,7,38
20172018,56,JEFFERSON,275,Jefferson County,260,Brandeis Elementary,56275260,210299000742,,909,76,66,142,104,108,212,10,13,23,50,60,110,2,0,2,0,0,0,12,10,22,254,257,511
20172018,56,JEFFERSON,275,Jefferson County,129,Breckinridge Metropolitan High,56275129,210299001965,,909,17,2,19,94,34,128,6,0,6,0,0,0,0,0,0,0,0,0,1,0,1,118,36,154
20172018,56,JEFFERSON,275,Jefferson County,38,Breckinridge-Franklin Elementary,56275038,210299001855,,909,73,50,123,126,126,252,16,6,22,2,5,7,0,1,1,1,0,1,24,21,45,242,209,451
20172018,56,JEFFERSON,275,Jefferson County,221,Brooklawn,56275221,210299002399,,909,54,26,80,16,6,22,1,2,3,1,0,1,0,0,0,0,0,0,5,1,6,77,35,112
20172018,56,JEFFERSON,275,Jefferson County,45,Butler Traditional High,56275045,210299000644,,909,377,387,764,339,378,717,40,35,75,23,21,44,0,0,0,0,2,2,20,24,44,799,847,1646
20172018,56,JEFFERSON,275,Jefferson County,243,Byck Elementary,56275243,210299000740,,909,14,6,20,169,182,351,6,5,11,2,1,3,1,0,1,0,0,0,7,3,10,199,197,396
20172018,56,JEFFERSON,275,Jefferson County,4,Camp Taylor Elementary,56275004,210299000623,,909,106,89,195,55,40,95,53,49,102,9,6,15,0,0,0,0,1,1,8,7,15,231,192,423
20172018,56,JEFFERSON,275,Jefferson County,5,Cane Run Elementary,56275005,210299000624,,909,28,12,40,154,141,295,3,3,6,0,0,0,0,0,0,0,0,0,6,9,15,191,165,356
20172018,56,JEFFERSON,275,Jefferson County,167,Carrithers Middle,56275167,210299000728,,909,170,149,319,124,134,258,21,34,55,8,4,12,0,0,0,0,1,1,10,21,31,333,343,676
20172018,56,JEFFERSON,275,Jefferson County,680,Carter Traditional Elementary,56275680,210299000784,,909,162,171,333,104,87,191,17,10,27,3,2,5,0,0,0,0,0,0,12,13,25,298,283,581
20172018,56,JEFFERSON,275,Jefferson County,179,Central High Magnet Career Academy,56275179,210299000730,,909,37,54,91,285,613,898,36,70,106,10,32,42,0,0,0,0,0,0,5,17,22,373,786,1159
20172018,56,JEFFERSON,275,Jefferson County,102,Chancey Elementary,56275102,210299001959,,909,115,102,217,123,114,237,53,48,101,10,14,24,0,0,0,0,0,0,25,36,61,326,314,640
20172018,56,JEFFERSON,275,Jefferson County,46,Chenoweth Elementary,56275046,210299000645,,909,156,152,308,65,54,119,9,17,26,11,8,19,0,0,0,0,0,0,18,21,39,259,252,511
20172018,56,JEFFERSON,275,Jefferson County,917,Churchill Park School,56275917,210299000789,,909,31,16,47,21,13,34,2,0,2,4,3,7,0,0,0,0,0,0,0,2,2,58,34,92
20172018,56,JEFFERSON,275,Jefferson County,323,Cochran Elementary,56275323,210299000751,,909,55,49,104,98,83,181,15,8,23,2,1,3,0,0,0,0,0,0,15,11,26,185,152,337
20172018,56,JEFFERSON,275,Jefferson County,83,Cochrane Elementary,56275083,210299000676,,909,87,76,163,48,50,98,57,68,125,8,15,23,0,0,0,1,0,1,11,22,33,212,231,443
20172018,56,JEFFERSON,275,Jefferson County,660,Coleridge-Taylor Montessori Elementary,56275660,210299000783,,909,66,58,124,196,197,393,3,9,12,1,4,5,0,0,0,0,1,1,10,9,19,276,278,554
20172018,56,JEFFERSON,275,Jefferson County,164,Conway Middle,56275164,210299000726,,909,249,172,421,152,145,297,20,21,41,4,1,5,2,0,2,0,0,0,18,13,31,445,352,797
20172018,56,JEFFERSON,275,Jefferson County,60,Coral Ridge Elementary,56275060,210299000654,,909,175,150,325,27,31,58,63,61,124,1,4,5,0,0,0,0,0,0,8,15,23,274,261,535
20172018,56,JEFFERSON,275,Jefferson County,119,Crosby Middle,56275119,210299000703,,909,324,289,613,156,133,289,41,45,86,25,32,57,1,0,1,1,0,1,18,25,43,566,524,1090
20172018,56,JEFFERSON,275,Jefferson County,92,Crums Lane Elementary,56275092,210299000684,,909,42,30,72,156,138,294,6,15,21,0,1,1,0,1,1,0,0,0,19,22,41,223,207,430
20172018,56,JEFFERSON,275,Jefferson County,82,Dixie Elementary,56275082,210299000675,,909,85,105,190,96,69,165,15,8,23,0,0,0,2,1,3,1,1,2,11,22,33,210,206,416
20172018,56,JEFFERSON,275,Jefferson County,100,Doss High,56275100,210299000691,,909,201,126,327,291,221,512,76,61,137,21,13,34,1,0,1,1,2,3,13,13,26,604,436,1040
20172018,56,JEFFERSON,275,Jefferson County,156,Dunn Elementary,56275156,210299000722,,909,182,159,341,50,38,88,9,11,20,25,22,47,0,0,0,0,1,1,14,20,34,280,251,531
20172018,56,JEFFERSON,275,Jefferson County,799,Early Learning Campus-U of L,56275799,,,909,0,0,0,0,0,0,0,0,0,0,0,0,0,0,0,0,0,0,0,0,0,0,0,0
20172018,56,JEFFERSON,275,Jefferson County,7,Eastern High,56275007,210299000625,,909,697,587,1284,221,217,438,71,58,129,49,42,91,0,1,1,1,1,2,35,28,63,1074,934,2008
20172018,56,JEFFERSON,275,Jefferson County,131,Eisenhower Elementary,56275131,210299000710,,909,196,225,421,53,47,100,7,10,17,0,1,1,0,1,1,0,0,0,15,20,35,271,304,575
20172018,56,JEFFERSON,275,Jefferson County,240,Engelhard Elementary,56275240,210299000739,,909,29,27,56,122,136,258,17,15,32,3,5,8,0,1,1,0,0,0,13,10,23,184,194,378
20172018,56,JEFFERSON,275,Jefferson County,10,Fairdale Elementary,56275010,210299000626,,909,155,124,279,47,36,83,81,69,150,13,14,27,0,1,1,1,1,2,18,12,30,315,257,572
20172018,56,JEFFERSON,275,Jefferson County,57,Fairdale High,56275057,210299000651,,909,354,344,698,121,103,224,102,107,209,14,14,28,1,1,2,0,1,1,14,6,20,606,576,1182
20172018,56,JEFFERSON,275,Jefferson County,212,Farmer Elementary,56275212,210299002187,,909,217,220,437,52,42,94,53,52,105,22,21,43,1,0,1,0,0,0,22,20,42,367,355,722
20172018,56,JEFFERSON,275,Jefferson County,49,Farnsley Middle,56275049,210299001530,,909,294,244,538,198,153,351,36,29,65,27,23,50,0,1,1,0,1,1,18,25,43,573,476,1049
20172018,56,JEFFERSON,275,Jefferson County,11,Fern Creek Elementary,56275011,210299000627,,909,130,127,257,86,82,168,44,50,94,32,20,52,0,0,0,0,0,0,16,21,37,308,300,608
20172018,56,JEFFERSON,275,Jefferson County,12,Fern Creek High,56275012,210299000628,,909,363,296,659,351,263,614,135,100,235,54,35,89,0,1,1,1,4,5,22,25,47,926,724,1650
20172018,56,JEFFERSON,275,Jefferson County,250,Field Elementary,56275250,210299000741,,909,124,97,221,52,49,101,7,11,18,12,13,25,0,0,0,1,0,1,18,11,29,214,181,395
20172018,56,JEFFERSON,275,Jefferson County,270,Foster Traditional Academy,56275270,210299000745,,909,13,17,30,231,249,480,9,9,18,0,0,0,0,1,1,0,0,0,5,6,11,258,282,540
20172018,56,JEFFERSON,275,Jefferson County,290,Frayser Elementary,56275290,210299000747,,909,32,23,55,96,114,210,40,24,64,8,7,15,1,0,1,0,0,0,6,7,13,183,175,358
20172018,56,JEFFERSON,275,Jefferson County,620,Frederick Law Olmsted Academy North,56275620,210299000781,,909,186,0,186,255,0,255,93,0,93,43,0,43,1,0,1,1,0,1,15,0,15,594,0,594
20172018,56,JEFFERSON,275,Jefferson County,730,Frederick Law Olmsted Academy South,56275730,210299001425,,909,0,225,225,0,297,297,0,108,108,0,33,33,0,0,0,0,3,3,0,22,22,0,688,688
20172018,56,JEFFERSON,275,Jefferson County,50,Georgia Chaffee Teenage Parent Program,56275050,210299001612,,909,0,15,15,0,17,17,0,13,13,0,0,0,0,0,0,0,0,0,0,4,4,0,49,49
20172018,56,JEFFERSON,275,Jefferson County,58,Gilmore Lane Elementary,56275058,210299000652,,909,44,57,101,49,63,112,29,16,45,0,1,1,0,0,0,0,0,0,5,2,7,127,139,266
20172018,56,JEFFERSON,275,Jefferson County,61,Goldsmith Elementary,56275061,210299000655,,909,94,60,154,102,99,201,71,75,146,28,22,50,0,0,0,3,1,4,10,20,30,308,277,585
20172018,56,JEFFERSON,275,Jefferson County,13,Greathouse/Shryock Traditional,56275013,210299000629,,909,165,174,339,40,54,94,8,14,22,53,50,103,0,0,0,1,1,2,17,17,34,284,310,594
20172018,56,JEFFERSON,275,Jefferson County,14,Greenwood Elementary,56275014,210299000630,,909,134,135,269,83,81,164,16,15,31,0,0,0,0,0,0,0,1,1,18,21,39,251,253,504
20172018,56,JEFFERSON,275,Jefferson County,115,Gutermuth Elementary,56275115,210299000700,,909,55,50,105,85,74,159,22,26,48,16,10,26,0,1,1,1,1,2,13,21,34,192,183,375
20172018,56,JEFFERSON,275,Jefferson County,121,Hartstern Elementary,56275121,210299000704,,909,95,78,173,63,53,116,87,55,142,11,11,22,0,0,0,0,0,0,15,10,25,271,207,478
20172018,56,JEFFERSON,275,Jefferson County,48,Hawthorne Elementary,56275048,210299000647,,909,93,106,199,37,34,71,50,48,98,5,5,10,0,1,1,0,0,0,10,10,20,195,204,399
20172018,56,JEFFERSON,275,Jefferson County,300,Hazelwood Elementary,56275300,210299000748,,909,48,61,109,50,45,95,48,40,88,18,11,29,0,0,0,0,1,1,17,12,29,181,170,351
20172018,56,JEFFERSON,275,Jefferson County,465,Heuser Hearing & Language Academy,56275465,210299001941,,909,1,1,2,1,1,2,0,0,0,1,0,1,0,0,0,0,0,0,0,0,0,3,2,5
20172018,56,JEFFERSON,275,Jefferson County,320,Highland Middle,56275320,210299000750,,909,171,216,387,172,199,371,29,54,83,7,14,21,1,0,1,0,2,2,17,21,38,397,506,903
20172018,56,JEFFERSON,275,Jefferson County,95,Hite Elementary,56275095,210299000686,,909,161,146,307,32,38,70,12,9,21,11,19,30,1,0,1,0,0,0,21,15,36,238,227,465
20172018,56,JEFFERSON,275,Jefferson County,768,Home of the Innocents Discovery,56275768,210299001943,,909,12,9,21,3,2,5,1,0,1,1,0,1,0,0,0,0,0,0,0,0,0,17,11,28
20172018,56,JEFFERSON,275,Jefferson County,769,Home of the Innocents School,56275769,210299001946,,909,12,29,41,5,5,10,2,0,2,0,0,0,0,0,0,0,0,0,0,1,1,19,35,54
20172018,56,JEFFERSON,275,Jefferson County,76,Indian Trail Elementary,56275076,210299000669,,909,36,34,70,94,113,207,59,65,124,4,5,9,1,0,1,0,0,0,16,14,30,210,231,441
20172018,56,JEFFERSON,275,Jefferson County,335,Iroquois High,56275335,210299000753,,909,167,95,262,374,308,682,91,73,164,54,41,95,0,1,1,2,1,3,13,11,24,701,530,1231
20172018,56,JEFFERSON,275,Jefferson County,165,J. Graham Brown School,56275165,210299002027,,909,198,232,430,59,108,167,18,24,42,12,16,28,0,1,1,0,1,1,18,24,42,305,406,711
20172018,56,JEFFERSON,275,Jefferson County,174,JCPS eSchool,56275174,210299002283,,909,0,0,0,0,0,0,0,0,0,0,0,0,0,0,0,0,0,0,0,0,0,0,0,0
20172018,56,JEFFERSON,275,Jefferson County,325,Jacob Elementary,56275325,210299000752,,909,93,69,162,174,170,344,15,14,29,2,2,4,0,0,0,0,0,0,25,20,45,309,275,584
20172018,56,JEFFERSON,275,Jefferson County,951,Jefferson County High,56275951,210299001947,,909,216,233,449,80,98,178,20,17,37,3,2,5,0,0,0,0,0,0,10,13,23,329,363,692
20172018,56,JEFFERSON,275,Jefferson County,396,Jefferson County Traditional Middle,56275396,210299000760,,909,265,257,522,131,171,302,16,25,41,9,13,22,1,0,1,0,0,0,14,20,34,436,486,922
20172018,56,JEFFERSON,275,Jefferson County,166,Jeffersontown Elementary,56275166,210299000727,,909,192,188,380,53,53,106,92,73,165,17,22,39,0,0,0,1,0,1,22,18,40,377,354,731
20172018,56,JEFFERSON,275,Jefferson County,65,Jeffersontown High,56275065,210299000659,,909,258,185,443,213,178,391,84,40,124,24,7,31,1,0,1,1,0,1,26,11,37,607,421,1028
20172018,56,JEFFERSON,275,Jefferson County,470,Johnson Traditional Middle,56275470,210299000769,,909,168,183,351,195,203,398,20,31,51,10,13,23,2,0,2,1,0,1,12,12,24,408,442,850
20172018,56,JEFFERSON,275,Jefferson County,106,Johnsontown Road Elementary,56275106,210299000696,,909,98,92,190,66,60,126,11,14,25,1,1,2,0,0,0,0,0,0,16,6,22,192,173,365
20172018,56,JEFFERSON,275,Jefferson County,162,Kammerer Middle,56275162,210299000724,,909,214,213,427,194,167,361,22,25,47,13,16,29,0,1,1,1,1,2,22,20,42,466,443,909
20172018,56,JEFFERSON,275,Jefferson County,720,Kennedy Montessori Elementary,56275720,210299000786,,909,38,34,72,211,227,438,24,30,54,2,3,5,0,0,0,1,1,2,9,13,22,285,308,593
20172018,56,JEFFERSON,275,Jefferson County,59,Kenwood Elementary,56275059,210299000653,,909,122,109,231,76,80,156,56,44,100,29,21,50,0,1,1,0,2,2,11,24,35,294,281,575
20172018,56,JEFFERSON,275,Jefferson County,79,Kerrick Elementary,56275079,210299000672,,909,140,97,237,77,83,160,8,18,26,1,1,2,0,2,2,0,0,0,19,7,26,245,208,453
20172018,56,JEFFERSON,275,Jefferson County,432,King Elementary,56275432,210299000762,,909,10,8,18,166,158,324,15,14,29,1,0,1,0,0,0,0,0,0,10,8,18,202,188,390
20172018,56,JEFFERSON,275,Jefferson County,134,Klondike Lane Elementary,56275134,210299000712,,909,60,68,128,56,56,112,66,60,126,16,15,31,0,0,0,0,0,0,11,15,26,209,214,423
20172018,56,JEFFERSON,275,Jefferson County,163,Knight Middle,56275163,210299000725,,909,123,105,228,59,55,114,38,34,72,2,2,4,0,2,2,1,1,2,5,7,12,228,206,434
20172018,56,JEFFERSON,275,Jefferson County,133,Lassiter Middle,56275133,210299000711,,909,234,216,450,128,127,255,106,102,208,30,15,45,0,0,0,2,1,3,11,14,25,511,475,986
20172018,56,JEFFERSON,275,Jefferson County,145,Laukhuf Elementary,56275145,210299000716,,909,140,135,275,47,38,85,28,15,43,9,2,11,2,0,2,0,1,1,16,11,27,242,202,444
20172018,56,JEFFERSON,275,Jefferson County,126,Layne Elementary,56275126,210299000706,,909,124,107,231,36,33,69,22,20,42,6,0,6,1,0,1,0,0,0,14,11,25,203,171,374
20172018,56,JEFFERSON,275,Jefferson County,30,Liberty High,56275030,210299001634,,909,50,26,76,90,91,181,2,4,6,0,2,2,0,1,1,0,0,0,4,4,8,146,128,274
20172018,56,JEFFERSON,275,Jefferson County,520,Lincoln Elementary Performing Arts,56275520,210299000772,,909,105,164,269,53,122,175,27,46,73,1,7,8,0,0,0,0,0,0,15,23,38,201,362,563
20172018,56,JEFFERSON,275,Jefferson County,138,Louisville Day,56275138,210299000713,,909,3,0,3,7,0,7,0,0,0,0,0,0,0,0,0,0,0,0,1,0,1,11,0,11
20172018,56,JEFFERSON,275,Jefferson County,47,Louisville Male High,56275047,210299001705,,909,548,579,1127,272,375,647,35,34,69,13,29,42,0,1,1,0,1,1,20,27,47,888,1046,1934
20172018,56,JEFFERSON,275,Jefferson County,463,Louisville Metro Youth Center,56275463,210299001082,,909,10,0,10,48,3,51,1,0,1,0,0,0,0,0,0,0,0,0,0,1,1,59,4,63
20172018,56,JEFFERSON,275,Jefferson County,146,Lowe Elementary,56275146,210299000717,,909,154,140,294,49,35,84,18,17,35,66,71,137,3,1,4,1,1,2,20,16,36,311,281,592
20172018,56,JEFFERSON,275,Jefferson County,107,Luhr Elementary,56275107,210299000697,,909,106,78,184,72,64,136,49,43,92,22,18,40,0,0,0,0,0,0,9,13,22,258,216,474
20172018,56,JEFFERSON,275,Jefferson County,155,Marion C. Moore School,56275155,210299002026,,909,407,392,799,383,368,751,260,197,457,35,27,62,1,4,5,1,2,3,29,29,58,1116,1019,2135
20172018,56,JEFFERSON,275,Jefferson County,193,Mary Jo and William MacDonald Maryhurst,56275193,210299001492,,909,0,48,48,0,12,12,0,3,3,0,0,0,0,0,0,0,0,0,0,1,1,0,64,64
20172018,56,JEFFERSON,275,Jefferson County,458,Mary Ryan Academy,56275458,210299001860,,909,15,10,25,2,3,5,1,1,2,0,0,0,0,0,0,0,0,0,0,1,1,18,15,33
20172018,56,JEFFERSON,275,Jefferson County,480,Maupin Elementary,56275480,210299000770,,909,2,5,7,121,122,243,2,2,4,2,2,4,0,0,0,0,0,0,5,7,12,132,138,270
20172018,56,JEFFERSON,275,Jefferson County,440,Mcferran Preparatory Academy,56275440,210299000764,,909,27,34,61,269,263,532,41,39,80,9,5,14,0,1,1,0,1,1,11,13,24,357,356,713
20172018,56,JEFFERSON,275,Jefferson County,22,Medora Elementary,56275022,210299000633,,909,166,171,337,32,23,55,17,18,35,0,0,0,0,0,0,1,1,2,14,14,28,230,227,457
20172018,56,JEFFERSON,275,Jefferson County,340,Meyzeek Middle,56275340,210299000754,,909,311,160,471,169,174,343,17,13,30,113,92,205,1,1,2,0,0,0,29,21,50,640,461,1101
20172018,56,JEFFERSON,275,Jefferson County,24,Middletown Elementary,56275024,210299000634,,909,176,145,321,48,56,104,23,21,44,22,19,41,0,0,0,0,0,0,18,14,32,287,255,542
20172018,56,JEFFERSON,275,Jefferson County,147,Mill Creek Elementary,56275147,210299000718,,909,28,29,57,178,191,369,3,10,13,0,1,1,0,0,0,0,0,0,18,16,34,227,247,474
20172018,56,JEFFERSON,275,Jefferson County,202,Minor Daniels Academy,56275202,210299002412,,909,30,9,39,115,66,181,8,1,9,0,0,0,0,0,0,0,0,0,12,2,14,165,78,243
20172018,56,JEFFERSON,275,Jefferson County,99,Minors Lane Elementary,56275099,210299000690,,909,36,43,79,74,52,126,87,108,195,6,7,13,0,0,0,0,1,1,6,4,10,209,215,424
20172018,56,JEFFERSON,275,Jefferson County,41,Newburg Middle,56275041,210299000642,,909,136,129,265,305,220,525,73,82,155,34,28,62,1,0,1,0,0,0,22,23,45,571,482,1053
20172018,56,JEFFERSON,275,Jefferson County,186,Newcomer Academy,56275186,210299002180,,909,35,31,66,113,100,213,224,132,356,21,6,27,0,0,0,1,0,1,0,0,0,394,269,663
20172018,56,JEFFERSON,275,Jefferson County,435,Noe Middle,56275435,210299000763,,909,276,392,668,225,236,461,42,57,99,22,40,62,0,1,1,0,0,0,18,32,50,583,758,1341
20172018,56,JEFFERSON,275,Jefferson County,371,Norton Commons Elementary,56275371,,,909,131,114,245,34,26,60,11,13,24,22,14,36,1,0,1,0,1,1,14,11,25,213,179,392
20172018,56,JEFFERSON,275,Jefferson County,96,Norton Elementary,56275096,210299000687,,909,247,230,477,41,29,70,18,16,34,46,37,83,1,2,3,1,1,2,17,22,39,371,337,708
20172018,56,JEFFERSON,275,Jefferson County,27,Okolona Elementary,56275027,210299000635,,909,55,51,106,42,50,92,23,37,60,0,1,1,1,0,1,0,0,0,15,10,25,136,149,285
20172018,56,JEFFERSON,275,Jefferson County,784,Peace Academy,56275784,210299001613,,909,45,47,92,27,20,47,4,3,7,0,0,0,0,0,0,0,0,0,2,4,6,78,74,152
20172018,56,JEFFERSON,275,Jefferson County,75,Pleasure Ridge Park High,56275075,210299000668,,909,486,518,1004,264,271,535,25,32,57,7,4,11,2,2,4,1,1,2,19,18,37,804,846,1650
20172018,56,JEFFERSON,275,Jefferson County,500,Portland Elementary,56275500,210299000771,,909,64,52,116,86,69,155,2,2,4,0,0,0,0,0,0,1,0,1,8,6,14,161,129,290
20172018,56,JEFFERSON,275,Jefferson County,128,Price Elementary,56275128,210299000708,,909,25,20,45,133,111,244,35,42,77,6,7,13,0,1,1,0,0,0,12,8,20,211,189,400
20172018,56,JEFFERSON,275,Jefferson County,219,Ramsey Middle,56275219,210299002190,,909,250,222,472,184,183,367,57,48,105,12,12,24,2,0,2,1,1,2,26,30,56,532,496,1028
20172018,56,JEFFERSON,275,Jefferson County,81,Rangeland Elementary,56275081,210299000674,,909,37,36,73,116,81,197,55,65,120,12,9,21,0,0,0,0,0,0,12,12,24,232,203,435
20172018,56,JEFFERSON,275,Jefferson County,85,Robert Frost Sixth-Grade Academy,56275085,210299000678,,909,129,95,224,90,75,165,27,12,39,2,4,6,0,0,0,0,0,0,14,11,25,262,197,459
20172018,56,JEFFERSON,275,Jefferson County,530,Roosevelt-Perry Elementary,56275530,210299000773,,909,15,15,30,112,94,206,3,6,9,0,0,0,1,0,1,0,0,0,5,7,12,136,122,258
20172018,56,JEFFERSON,275,Jefferson County,560,Rutherford Elementary,56275560,210299000775,,909,74,60,134,83,76,159,56,38,94,37,34,71,0,1,1,2,0,2,16,10,26,268,219,487
20172018,56,JEFFERSON,275,Jefferson County,86,Sanders Elementary,56275086,210299000679,,909,136,117,253,61,62,123,13,13,26,1,1,2,0,0,0,1,1,2,17,9,26,229,203,432
20172018,56,JEFFERSON,275,Jefferson County,63,Schaffner Traditional Elementary,56275063,210299001587,,909,155,165,320,89,112,201,12,16,28,4,3,7,0,0,0,1,0,1,9,14,23,270,310,580
20172018,56,JEFFERSON,275,Jefferson County,580,Semple Elementary,56275580,210299000776,,909,103,80,183,133,116,249,32,32,64,7,6,13,0,0,0,0,2,2,23,27,50,298,263,561
20172018,56,JEFFERSON,275,Jefferson County,73,Seneca High,56275073,210299000667,,909,207,216,423,239,253,492,128,100,228,29,17,46,3,2,5,2,0,2,18,24,42,626,612,1238
20172018,56,JEFFERSON,275,Jefferson County,97,Shacklette Elementary,56275097,210299000688,,909,67,51,118,72,74,146,42,31,73,10,2,12,0,0,0,0,0,0,6,8,14,197,166,363
20172018,56,JEFFERSON,275,Jefferson County,610,Shelby Traditional Academy,56275610,210299000780,,909,80,71,151,220,221,441,39,49,88,6,7,13,0,1,1,1,0,1,24,17,41,370,366,736
20172018,56,JEFFERSON,275,Jefferson County,103,Slaughter Elementary,56275103,210299000693,,909,22,20,42,64,63,127,115,86,201,7,6,13,0,0,0,0,0,0,5,6,11,213,181,394
20172018,56,JEFFERSON,275,Jefferson County,87,Smyrna Elementary School,56275087,210299000680,,909,111,99,210,77,74,151,28,27,55,8,6,14,0,0,0,0,0,0,17,18,35,241,224,465
20172018,56,JEFFERSON,275,Jefferson County,31,Southern High,56275031,210299000637,,909,351,207,558,233,179,412,141,118,259,16,15,31,0,0,0,0,2,2,12,15,27,753,536,1289
20172018,56,JEFFERSON,275,Jefferson County,29,St Joseph Children's Home,56275029,210299001633,,909,25,12,37,1,3,4,0,0,0,0,0,0,0,0,0,0,0,0,3,0,3,29,15,44
20172018,56,JEFFERSON,275,Jefferson County,64,St Matthews Elementary,56275064,210299000658,,909,167,150,317,74,66,140,11,9,20,13,11,24,0,1,1,0,0,0,21,21,42,286,258,544
20172018,56,JEFFERSON,275,Jefferson County,71,Stonestreet Elementary,56275071,210299000665,,909,164,117,281,21,17,38,31,35,66,1,5,6,0,0,0,6,3,9,12,14,26,235,191,426
20172018,56,JEFFERSON,275,Jefferson County,211,Stopher Elementary,56275211,210299002197,,909,265,249,514,30,41,71,13,17,30,46,38,84,0,0,0,1,1,2,20,17,37,375,363,738
20172018,56,JEFFERSON,275,Jefferson County,144,Stuart Academy,56275144,210299001427,,909,155,162,317,169,156,325,33,32,65,3,0,3,2,1,3,0,3,3,12,14,26,374,368,742
20172018,56,JEFFERSON,275,Jefferson County,590,The Academy @ Shawnee,56275590,210299000777,,909,147,90,237,190,113,303,14,7,21,5,2,7,0,1,1,0,0,0,8,7,15,364,220,584
20172018,56,JEFFERSON,275,Jefferson County,19,The Brook-Dupont,56275019,210299001629,,909,3,2,5,1,2,3,0,0,0,0,0,0,0,0,0,0,0,0,0,0,0,4,4,8
20172018,56,JEFFERSON,275,Jefferson County,20,The Brook-KMI,56275020,210299001474,,909,16,18,34,3,4,7,0,0,0,0,0,0,0,0,0,0,0,0,0,0,0,19,22,41
20172018,56,JEFFERSON,275,Jefferson County,201,The Phoenix School of Discovery,56275201,210299002121,,909,168,90,258,57,38,95,8,4,12,1,1,2,1,1,2,0,0,0,11,4,15,246,138,384
20172018,56,JEFFERSON,275,Jefferson County,90,Thomas Jefferson Middle,56275090,210299000682,,909,136,108,244,243,195,438,112,120,232,19,16,35,0,0,0,2,1,3,14,11,25,526,451,977
20172018,56,JEFFERSON,275,Jefferson County,104,Trunnell Elementary,56275104,210299000694,,909,86,91,177,88,93,181,35,35,70,9,7,16,1,0,1,2,0,2,12,14,26,233,240,473
20172018,56,JEFFERSON,275,Jefferson County,16,Tully Elementary,56275016,210299000631,,909,237,232,469,49,44,93,27,21,48,18,13,31,0,0,0,0,0,0,20,25,45,351,335,686
20172018,56,JEFFERSON,275,Jefferson County,124,U of L PACT Program,56275124,210299001935,,909,5,2,7,2,1,3,0,0,0,0,0,0,0,0,0,0,0,0,0,0,0,7,3,10
20172018,56,JEFFERSON,275,Jefferson County,33,Valley High,56275033,210299000639,,909,263,292,555,192,194,386,18,22,40,5,2,7,1,1,2,0,1,1,11,18,29,490,530,1020
20172018,56,JEFFERSON,275,Jefferson County,191,W.E.B. DuBois Academy,56275191,,,909,0,0,0,0,0,0,0,0,0,0,0,0,0,0,0,0,0,0,0,0,0,0,0,0
20172018,56,JEFFERSON,275,Jefferson County,51,Waggener High,56275051,210299000649,,909,128,127,255,220,215,435,82,55,137,10,8,18,0,1,1,0,0,0,9,12,21,449,418,867
20172018,56,JEFFERSON,275,Jefferson County,34,Waller-Williams Environmental,56275034,210299001529,,909,25,4,29,71,15,86,4,0,4,0,0,0,0,0,0,0,0,0,8,0,8,108,19,127
20172018,56,JEFFERSON,275,Jefferson County,69,Watson Lane Elementary,56275069,210299000663,,909,113,108,221,18,18,36,7,8,15,0,0,0,0,0,0,1,0,1,15,9,24,154,143,297
20172018,56,JEFFERSON,275,Jefferson County,72,Watterson Elementary,56275072,210299000666,,909,119,78,197,134,104,238,34,25,59,7,9,16,0,0,0,0,2,2,20,18,38,314,236,550
20172018,56,JEFFERSON,275,Jefferson County,116,Wellington Elementary,56275116,210299000701,,909,64,87,151,128,117,245,8,13,21,1,0,1,0,0,0,0,0,0,15,12,27,216,229,445
20172018,56,JEFFERSON,275,Jefferson County,110,Western Day Treatment,56275110,210299001857,,909,9,0,9,8,2,10,0,0,0,0,0,0,0,0,0,0,0,0,0,0,0,17,2,19
20172018,56,JEFFERSON,275,Jefferson County,84,Western High,56275084,210299000677,,909,85,78,163,275,216,491,18,19,37,0,0,0,1,0,1,1,0,1,7,7,14,387,320,707
20172018,56,JEFFERSON,275,Jefferson County,710,Western Middle School for the Arts,56275710,210299000785,,909,44,111,155,113,260,373,13,29,42,8,5,13,0,0,0,1,1,2,13,12,25,192,418,610
20172018,56,JEFFERSON,275,Jefferson County,77,Westport Middle,56275077,210299000670,,909,298,257,555,202,186,388,87,85,172,23,20,43,2,4,6,0,2,2,28,35,63,640,589,1229
20172018,56,JEFFERSON,275,Jefferson County,916,Westport TAPP,56275916,210299001098,,909,0,12,12,0,34,34,0,3,3,0,0,0,0,0,0,0,0,0,0,2,2,0,51,51
20172018,56,JEFFERSON,275,Jefferson County,182,Wheatley Elementary,56275182,210299000731,,909,8,7,15,140,143,283,14,10,24,0,0,0,0,0,0,0,0,0,2,6,8,164,166,330
20172018,56,JEFFERSON,275,Jefferson County,109,Wheeler Elementary,56275109,210299000699,,909,234,196,430,66,59,125,23,21,44,14,12,26,1,1,2,1,0,1,21,23,44,360,312,672
20172018,56,JEFFERSON,275,Jefferson County,67,Wilder Elementary,56275067,210299000661,,909,149,141,290,72,70,142,26,16,42,19,24,43,0,0,0,0,0,0,16,21,37,282,272,554
20172018,56,JEFFERSON,275,Jefferson County,66,Wilkerson Elementary School,56275066,210299000660,,909,143,101,244,46,54,100,29,40,69,1,2,3,0,0,0,0,0,0,10,16,26,229,213,442
20172018,56,JEFFERSON,275,Jefferson County,117,Wilt Elementary,56275117,210299000702,,909,141,119,260,50,42,92,36,34,70,17,12,29,1,3,4,0,0,0,14,7,21,259,217,476
20172018,56,JEFFERSON,275,Jefferson County,374,Young Elementary,56275374,210299000757,,909,17,12,29,148,171,319,54,46,100,5,2,7,0,1,1,0,0,0,6,11,17,230,243,473
20172018,56,JEFFERSON,275,Jefferson County,78,Zachary Taylor Elementary,56275078,210299000671,,909,64,45,109,96,111,207,44,37,81,9,6,15,0,0,0,0,2,2,17,19,36,230,220,450
20172018,56,JEFFERSON,275,Jefferson County,200,duPont Manual High,56275200,210299000734,,909,476,693,1169,92,183,275,34,51,85,156,169,325,1,3,4,4,4,8,20,23,43,783,1126,1909
20172018,56,JEFFERSON,275,Jefferson County,,---District Total---,,,,909,21421,20301,41722,17280,17018,34298,5443,5132,10575,2019,1909,3928,56,60,116,65,77,142,2090,2134,4224,48374,46631,95005
20172018,67,LETCHER,276,Jenkins Independent,11,Jenkins Independent School,67276011,210300001642,KVEC,904,211,175,386,1,2,3,7,1,8,1,0,1,0,0,0,0,0,0,1,0,1,221,178,399
20172018,67,LETCHER,276,Jenkins Independent,,---District Total---,,,KVEC,904,211,175,386,1,2,3,7,1,8,1,0,1,0,0,0,0,0,0,1,0,1,221,178,399
20172018,57,JESSAMINE,281,Jessamine County,30,Ashgrove Academy,57281030,,CKEC,901,8,5,13,0,1,1,0,0,0,0,0,0,0,0,0,0,0,0,0,0,0,8,6,14
20172018,57,JESSAMINE,281,Jessamine County,70,Brookside Elementary School,57281070,210303001429,CKEC,901,205,219,424,26,22,48,27,29,56,1,4,5,0,1,1,0,0,0,23,22,45,282,297,579
20172018,57,JESSAMINE,281,Jessamine County,21,East Jessamine High School,57281021,210303001641,CKEC,901,466,381,847,36,34,70,22,17,39,2,5,7,0,0,0,1,1,2,17,18,35,544,456,1000
20172018,57,JESSAMINE,281,Jessamine County,25,East Jessamine Middle School,57281025,210303000797,CKEC,901,356,332,688,34,22,56,36,27,63,2,6,8,1,1,2,0,1,1,20,22,42,449,411,860
20172018,57,JESSAMINE,281,Jessamine County,18,Hattie C. Warner Elementary School,57281018,210303000795,CKEC,901,231,218,449,16,12,28,16,21,37,1,1,2,0,2,2,1,1,2,15,13,28,280,268,548
20172018,57,JESSAMINE,281,Jessamine County,24,Jessamine Career and Technology Center,57281024,210303002028,CKEC,901,0,0,0,0,0,0,0,0,0,0,0,0,0,0,0,0,0,0,0,0,0,0,0,0
20172018,57,JESSAMINE,281,Jessamine County,22,Jessamine Early Learning Village,57281022,210303001899,CKEC,901,228,220,448,20,18,38,17,19,36,0,4,4,0,0,0,0,0,0,22,12,34,287,273,560
20172018,57,JESSAMINE,281,Jessamine County,50,Nicholasville Elementary School,57281050,210303000798,CKEC,901,179,171,350,11,15,26,24,13,37,1,1,2,1,1,2,0,0,0,15,12,27,231,213,444
20172018,57,JESSAMINE,281,Jessamine County,40,Red Oak Elementary School,57281040,210303002388,CKEC,901,222,236,458,15,26,41,19,26,45,0,1,1,0,0,0,0,0,0,8,9,17,264,298,562
20172018,57,JESSAMINE,281,Jessamine County,60,Rosenwald Dunbar Elementary School,57281060,210303000092,CKEC,901,265,215,480,31,19,50,19,24,43,0,4,4,2,2,4,1,0,1,7,10,17,325,274,599
20172018,57,JESSAMINE,281,Jessamine County,23,The Providence School,57281023,210303001900,CKEC,901,67,48,115,6,9,15,1,2,3,0,0,0,0,0,0,0,1,1,3,4,7,77,64,141
20172018,57,JESSAMINE,281,Jessamine County,19,West Jessamine High School,57281019,210303001640,CKEC,901,503,525,1028,28,30,58,37,32,69,8,16,24,0,2,2,0,0,0,19,24,43,595,629,1224
20172018,57,JESSAMINE,281,Jessamine County,26,West Jessamine Middle School,57281026,210303001110,CKEC,901,397,385,782,24,23,47,20,34,54,6,9,15,0,2,2,0,0,0,16,16,32,463,469,932
20172018,57,JESSAMINE,281,Jessamine County,90,Wilmore Elementary School,57281090,210303000799,CKEC,901,252,218,470,15,20,35,14,11,25,8,5,13,2,0,2,0,0,0,8,4,12,299,258,557
20172018,57,JESSAMINE,281,Jessamine County,,---District Total---,,,CKEC,901,3379,3173,6552,262,251,513,252,255,507,29,56,85,6,11,17,3,4,7,173,166,339,4104,3916,8020
20172018,58,JOHNSON,285,Johnson County,75,Central Elementary School,58285075,210306000692,KEDC,903,215,175,390,0,2,2,3,3,6,0,0,0,0,0,0,0,1,1,1,2,3,219,183,402
20172018,58,JOHNSON,285,Johnson County,100,Flat Gap Elementary School,58285100,210306000801,KEDC,903,128,130,258,0,0,0,0,1,1,0,0,0,0,0,0,0,0,0,0,0,0,128,131,259
20172018,58,JOHNSON,285,Johnson County,340,Highland Elementary School,58285340,210306000806,KEDC,903,222,219,441,0,0,0,2,1,3,3,2,5,0,0,0,0,0,0,4,6,10,231,228,459
20172018,58,JOHNSON,285,Johnson County,115,Johnson Central High School,58285115,210306000802,KEDC,903,548,499,1047,0,0,0,3,2,5,3,2,5,1,0,1,0,0,0,2,3,5,557,506,1063
20172018,58,JOHNSON,285,Johnson County,50,Johnson County Alternative School,58285050,210306001615,KEDC,903,15,1,16,1,0,1,2,0,2,0,0,0,0,0,0,0,0,0,0,0,0,18,1,19
20172018,58,JOHNSON,285,Johnson County,60,Johnson County Middle School,58285060,210306000800,KEDC,903,295,234,529,0,1,1,2,1,3,3,1,4,0,0,0,0,0,0,3,2,5,303,239,542
20172018,58,JOHNSON,285,Johnson County,250,Porter Elementary School,58285250,210306000803,KEDC,903,173,178,351,0,0,0,1,2,3,2,0,2,0,0,0,0,0,0,3,2,5,179,182,361
20172018,58,JOHNSON,285,Johnson County,320,W R Castle Memorial Elementary School,58285320,210306000805,KEDC,903,174,179,353,0,2,2,0,0,0,0,0,0,0,0,0,0,0,0,0,1,1,174,182,356
20172018,58,JOHNSON,285,Johnson County,,---District Total---,,,KEDC,903,1770,1615,3385,1,5,6,13,10,23,11,5,16,1,0,1,0,1,1,13,16,29,1809,1652,3461
20172018,59,KENTON,291,Kenton County,5,Beechgrove Elementary School,59291005,210309000807,NKCES,905,290,284,574,13,9,22,15,20,35,3,3,6,0,0,0,0,0,0,23,25,48,344,341,685
20172018,59,KENTON,291,Kenton County,40,Dixie Heights High School,59291040,210309000811,NKCES,905,628,555,1183,20,24,44,50,39,89,20,27,47,2,5,7,3,1,4,22,35,57,745,686,1431
20172018,59,KENTON,291,Kenton County,60,Ft Wright Elementary School,59291060,210309000815,NKCES,905,171,174,345,9,9,18,25,17,42,3,2,5,0,0,0,0,1,1,15,27,42,223,230,453
20172018,59,KENTON,291,Kenton County,20,James A Caywood Elementary School,59291020,210309000809,NKCES,905,211,221,432,4,8,12,44,50,94,1,1,2,0,0,0,2,3,5,21,27,48,283,310,593
20172018,59,KENTON,291,Kenton County,903,Kenton CO Academies of Innovation & Tech,59291903,210309002092,NKCES,905,235,263,498,4,8,12,10,9,19,2,5,7,0,1,1,0,0,0,0,12,12,251,298,549
20172018,59,KENTON,291,Kenton County,50,Kenton Elementary School,59291050,210309000813,NKCES,905,305,256,561,1,6,7,7,9,16,3,0,3,0,0,0,0,0,0,5,14,19,321,285,606
20172018,59,KENTON,291,Kenton County,55,Northern Ky Youth Dev Center,59291055,210309000814,NKCES,905,14,0,14,7,0,7,1,0,1,0,0,0,0,0,0,0,0,0,1,0,1,23,0,23
20172018,59,KENTON,291,Kenton County,70,Piner Elementary School,59291070,210309000816,NKCES,905,165,160,325,0,1,1,6,5,11,0,0,0,0,0,0,1,0,1,1,3,4,173,169,342
20172018,59,KENTON,291,Kenton County,45,R C Hinsdale Elementary School,59291045,210309000812,NKCES,905,282,245,527,7,13,20,5,11,16,8,5,13,0,0,0,0,0,0,10,12,22,312,286,598
20172018,59,KENTON,291,Kenton County,6,River Ridge Elementary School,59291006,210309001512,NKCES,905,331,339,670,13,16,29,25,30,55,30,35,65,0,0,0,2,5,7,32,31,63,433,456,889
20172018,59,KENTON,291,Kenton County,80,Ryland Heights Elementary School,59291080,210309000817,NKCES,905,269,214,483,5,3,8,4,9,13,0,4,4,0,0,0,0,1,1,7,8,15,285,239,524
20172018,59,KENTON,291,Kenton County,120,Scott High School,59291120,210309000823,NKCES,905,449,421,870,18,7,25,16,13,29,4,4,8,1,0,1,1,0,1,21,19,40,510,464,974
20172018,59,KENTON,291,Kenton County,90,Simon Kenton High School,59291090,210309000818,NKCES,905,899,807,1706,13,9,22,26,15,41,5,7,12,1,1,2,0,1,1,20,28,48,964,868,1832
20172018,59,KENTON,291,Kenton County,475,Summit View Academy,59291475,210309002420,NKCES,905,625,598,1223,20,17,37,26,29,55,5,3,8,0,2,2,0,0,0,36,36,72,712,685,1397
20172018,59,KENTON,291,Kenton County,100,Taylor Mill Elementary School,59291100,210309000819,NKCES,905,267,222,489,14,6,20,10,13,23,6,4,10,0,0,0,0,0,0,13,14,27,310,259,569
20172018,59,KENTON,291,Kenton County,103,Turkey Foot Middle School,59291103,210309000820,NKCES,905,431,455,886,12,24,36,47,36,83,11,13,24,1,1,2,2,3,5,23,35,58,527,567,1094
20172018,59,KENTON,291,Kenton County,105,Twenhofel Middle School,59291105,210309000821,NKCES,905,361,380,741,4,2,6,10,5,15,4,2,6,0,0,0,0,0,0,9,12,21,388,401,789
20172018,59,KENTON,291,Kenton County,495,White's Tower Elementary School,59291495,210309000824,NKCES,905,260,262,522,2,7,9,4,3,7,0,0,0,0,1,1,0,1,1,10,11,21,276,285,561
20172018,59,KENTON,291,Kenton County,108,Woodland Middle School,59291108,210309001588,NKCES,905,334,288,622,17,11,28,11,12,23,2,5,7,0,0,0,1,0,1,22,10,32,387,326,713
20172018,59,KENTON,291,Kenton County,,---District Total---,,,NKCES,905,6527,6144,12671,183,180,363,342,325,667,107,120,227,5,11,16,12,16,28,291,359,650,7467,7155,14622
20172018,60,KNOTT,295,Knott County,35,Beaver Creek Elementary School,60295035,210312000826,KVEC,904,117,132,249,0,0,0,1,0,1,0,0,0,0,0,0,0,0,0,0,0,0,118,132,250
20172018,60,KNOTT,295,Knott County,100,Carr Creek Elementary School,60295100,210312000830,KVEC,904,181,165,346,7,3,10,1,0,1,0,0,0,1,0,1,0,0,0,1,0,1,191,168,359
20172018,60,KNOTT,295,Knott County,150,Cordia School,60295150,210312002233,KVEC,904,98,86,184,9,0,9,6,2,8,0,0,0,0,0,0,0,0,0,0,0,0,113,88,201
20172018,60,KNOTT,295,Knott County,210,Emmalena Elementary School,60295210,210312000834,KVEC,904,97,90,187,0,0,0,1,1,2,0,0,0,0,0,0,0,0,0,0,0,0,98,91,189
20172018,60,KNOTT,295,Knott County,230,Hindman Elementary School,60295230,210312000835,KVEC,904,246,241,487,3,1,4,5,5,10,0,0,0,0,0,0,0,0,0,1,1,2,255,248,503
20172018,60,KNOTT,295,Knott County,255,Jones Fork Elementary School,60295255,210312000836,KVEC,904,100,52,152,1,1,2,2,1,3,0,0,0,0,0,0,0,0,0,0,0,0,103,54,157
20172018,60,KNOTT,295,Knott County,265,Knott County Central High School,60295265,210312000837,KVEC,904,287,255,542,3,3,6,0,1,1,0,0,0,0,0,0,0,0,0,0,0,0,290,259,549
20172018,60,KNOTT,295,Knott County,,---District Total---,,,KVEC,904,1126,1021,2147,23,8,31,16,10,26,0,0,0,1,0,1,0,0,0,2,1,3,1168,1040,2208
20172018,61,KNOX,301,Knox County,71,Central Elementary School,61301071,210315002235,SESC,907,223,205,428,6,6,12,4,4,8,0,0,0,0,0,0,0,0,0,4,3,7,237,218,455
20172018,61,KNOX,301,Knox County,170,Dewitt Elementary School,61301170,210315000842,SESC,907,80,82,162,2,1,3,0,0,0,0,0,0,0,0,0,0,0,0,0,0,0,82,83,165
20172018,61,KNOX,301,Knox County,240,Flat Lick Elementary School,61301240,210315000843,SESC,907,98,101,199,0,1,1,1,0,1,0,1,1,0,0,0,0,0,0,0,0,0,99,103,202
20172018,61,KNOX,301,Knox County,320,G R Hampton Elementary School,61301320,210315000846,SESC,907,129,110,239,0,0,0,0,1,1,1,1,2,0,0,0,0,0,0,2,2,4,132,114,246
20172018,61,KNOX,301,Knox County,260,Girdler Elementary School,61301260,210315000844,SESC,907,170,167,337,2,3,5,0,5,5,0,0,0,0,1,1,0,0,0,0,1,1,172,177,349
20172018,61,KNOX,301,Knox County,430,Jesse D Lay Elementary School,61301430,210315000848,SESC,907,142,153,295,0,1,1,4,2,6,0,1,1,0,0,0,0,0,0,0,0,0,146,157,303
20172018,61,KNOX,301,Knox County,22,Knox Appalachian School,61301022,210315001997,SESC,907,24,7,31,4,1,5,3,3,6,0,0,0,0,0,0,0,0,0,6,0,6,37,11,48
20172018,61,KNOX,301,Knox County,410,Knox Central High School,61301410,210315000847,SESC,907,407,366,773,12,7,19,3,6,9,4,0,4,0,0,0,0,0,0,6,3,9,432,382,814
20172018,61,KNOX,301,Knox County,140,Knox County Day Treatment,61301140,210315002357,SESC,907,22,8,30,1,0,1,0,0,0,0,0,0,0,0,0,0,0,0,0,0,0,23,8,31
20172018,61,KNOX,301,Knox County,150,Knox County Learning Academy,61301150,210315000709,SESC,907,37,26,63,2,2,4,0,0,0,0,1,1,0,0,0,0,0,0,0,0,0,39,29,68
20172018,61,KNOX,301,Knox County,23,Knox County Middle School,61301023,210315002029,SESC,907,209,216,425,2,6,8,1,2,3,1,1,2,0,0,0,0,0,0,1,6,7,214,231,445
20172018,61,KNOX,301,Knox County,155,Knox Inspire Academy,61301155,,SESC,907,7,10,17,0,0,0,0,0,0,0,0,0,0,0,0,0,0,0,0,0,0,7,10,17
20172018,61,KNOX,301,Knox County,450,Lynn Camp Schools,61301450,210315000850,SESC,907,554,488,1042,4,4,8,10,6,16,0,0,0,3,1,4,1,1,2,5,6,11,577,506,1083
20172018,61,KNOX,301,Knox County,,---District Total---,,,SESC,907,2102,1939,4041,35,32,67,26,29,55,6,5,11,3,2,5,1,1,2,24,21,45,2197,2029,4226
20172018,62,LARUE,305,LaRue County,15,Abraham Lincoln Elementary School,62305015,210318002044,GRREC,902,243,212,455,3,1,4,8,19,27,0,0,0,0,0,0,0,0,0,10,8,18,264,240,504
20172018,62,LARUE,305,LaRue County,30,Hodgenville Elementary School,62305030,210318000852,GRREC,902,226,211,437,4,11,15,20,20,40,0,1,1,0,0,0,0,0,0,12,9,21,262,252,514
20172018,62,LARUE,305,LaRue County,40,LaRue County High School,62305040,210318000853,GRREC,902,328,292,620,23,7,30,17,25,42,3,2,5,2,1,3,0,1,1,12,12,24,385,340,725
20172018,62,LARUE,305,LaRue County,45,LaRue County Middle School,62305045,210318000854,GRREC,902,239,242,481,2,3,5,18,17,35,2,1,3,0,2,2,1,0,1,12,8,20,274,273,547
20172018,62,LARUE,305,LaRue County,100,The Life Connection,62305100,210318002216,GRREC,902,38,0,38,2,0,2,1,0,1,0,0,0,0,0,0,0,0,0,0,0,0,41,0,41
20172018,62,LARUE,305,LaRue County,,---District Total---,,,GRREC,902,1074,957,2031,34,22,56,64,81,145,5,4,9,2,3,5,1,1,2,46,37,83,1226,1105,2331
20172018,63,LAUREL,311,Laurel County,30,Bush Elementary School,63311030,210321000857,SESC,907,233,203,436,2,2,4,3,0,3,4,4,8,0,0,0,1,0,1,0,1,1,243,210,453
20172018,63,LAUREL,311,Laurel County,55,Camp Ground Elementary School,63311055,210321000859,SESC,907,132,150,282,4,0,4,1,1,2,0,0,0,0,0,0,0,0,0,1,2,3,138,153,291
20172018,63,LAUREL,311,Laurel County,430,Cold Hill Elementary School,63311430,210321001483,SESC,907,123,117,240,0,0,0,1,2,3,2,2,4,0,0,0,0,1,1,1,3,4,127,125,252
20172018,63,LAUREL,311,Laurel County,70,Colony Elementary School,63311070,210321000860,SESC,907,166,167,333,1,1,2,1,0,1,0,1,1,1,0,1,0,0,0,1,6,7,170,175,345
20172018,63,LAUREL,311,Laurel County,130,Hazel Green Elementary School,63311130,210321000862,SESC,907,144,137,281,0,0,0,3,3,6,0,0,0,0,0,0,0,0,0,1,0,1,148,140,288
20172018,63,LAUREL,311,Laurel County,175,Hunter Hills Elementary School,63311175,210321000715,SESC,907,298,281,579,3,2,5,7,10,17,1,0,1,0,0,0,0,1,1,7,3,10,316,297,613
20172018,63,LAUREL,311,Laurel County,165,Johnson Elementary School,63311165,210321000863,SESC,907,158,116,274,3,1,4,1,1,2,1,2,3,0,0,0,0,0,0,2,0,2,165,120,285
20172018,63,LAUREL,311,Laurel County,180,Keavy Elementary School,63311180,210321000864,SESC,907,123,128,251,1,1,2,2,2,4,0,0,0,0,0,0,0,0,0,2,2,4,128,133,261
20172018,63,LAUREL,311,Laurel County,60,Laurel Co Schools Center for Innovation,63311060,210321002400,SESC,907,0,0,0,0,0,0,0,0,0,0,0,0,0,0,0,0,0,0,0,0,0,0,0,0
20172018,63,LAUREL,311,Laurel County,50,Laurel County Day Treatment,63311050,210321001677,SESC,907,26,13,39,2,0,2,2,0,2,0,0,0,0,0,0,0,0,0,0,0,0,30,13,43
20172018,63,LAUREL,311,Laurel County,19,Laurel County Virtual Academy,63311019,,SESC,907,5,16,21,0,0,0,0,0,0,0,0,0,0,0,0,0,0,0,0,0,0,5,16,21
20172018,63,LAUREL,311,Laurel County,10,London Elementary School,63311010,210321000856,SESC,907,268,247,515,0,3,3,15,15,30,3,0,3,0,0,0,0,0,0,7,3,10,293,268,561
20172018,63,LAUREL,311,Laurel County,16,McDaniel Learning Center,63311016,210321002224,SESC,907,13,5,18,3,0,3,0,0,0,0,0,0,0,0,0,0,0,0,0,0,0,16,5,21
20172018,63,LAUREL,311,Laurel County,205,North Laurel High School,63311205,210321000215,SESC,907,663,635,1298,10,10,20,8,5,13,5,3,8,3,4,7,0,0,0,2,6,8,691,663,1354
20172018,63,LAUREL,311,Laurel County,200,North Laurel Middle School,63311200,210321001589,SESC,907,511,468,979,6,6,12,9,5,14,5,7,12,1,3,4,1,0,1,1,3,4,534,492,1026
20172018,63,LAUREL,311,Laurel County,210,South Laurel High School,63311210,210321000865,SESC,907,566,549,1115,6,13,19,10,9,19,11,3,14,2,1,3,1,1,2,6,5,11,602,581,1183
20172018,63,LAUREL,311,Laurel County,40,South Laurel Middle School,63311040,210321000858,SESC,907,497,466,963,5,5,10,11,11,22,8,5,13,1,1,2,3,1,4,4,4,8,529,493,1022
20172018,63,LAUREL,311,Laurel County,420,Sublimity Elementary School,63311420,210321000869,SESC,907,177,137,314,3,2,5,2,3,5,0,0,0,0,0,0,0,0,0,3,3,6,185,145,330
20172018,63,LAUREL,311,Laurel County,18,Wyan-Pine Grove Elementary,63311018,210321002030,SESC,907,202,183,385,2,2,4,13,10,23,6,5,11,0,0,0,0,0,0,4,7,11,227,207,434
20172018,63,LAUREL,311,Laurel County,,---District Total---,,,SESC,907,4305,4018,8323,51,48,99,89,77,166,46,32,78,8,9,17,6,4,10,42,48,90,4547,4236,8783
20172018,64,LAWRENCE,315,Lawrence County,30,Blaine Elementary School,64315030,210324000870,KEDC,903,89,81,170,1,3,4,1,1,2,0,0,0,0,0,0,0,0,0,0,0,0,91,85,176
20172018,64,LAWRENCE,315,Lawrence County,150,Fallsburg Elementary School,64315150,210324000871,KEDC,903,145,116,261,1,0,1,2,1,3,0,0,0,0,0,0,0,0,0,0,1,1,148,118,266
20172018,64,LAWRENCE,315,Lawrence County,260,Lawrence County High School,64315260,210324000874,KEDC,903,342,317,659,2,4,6,0,2,2,1,1,2,0,1,1,0,0,0,1,2,3,346,327,673
20172018,64,LAWRENCE,315,Lawrence County,20,Louisa East Elementary School,64315020,210324002079,KEDC,903,284,302,586,4,3,7,5,3,8,1,0,1,1,0,1,0,0,0,4,4,8,299,312,611
20172018,64,LAWRENCE,315,Lawrence County,200,Louisa Middle School,64315200,210324000872,KEDC,903,223,217,440,2,0,2,3,2,5,1,3,4,0,0,0,0,0,0,1,0,1,230,222,452
20172018,64,LAWRENCE,315,Lawrence County,21,Louisa West Elementary School,64315021,210324002155,KEDC,903,131,126,257,0,0,0,2,0,2,1,0,1,0,0,0,0,0,0,0,1,1,134,127,261
20172018,64,LAWRENCE,315,Lawrence County,,---District Total---,,,KEDC,903,1214,1159,2373,10,10,20,13,9,22,4,4,8,1,1,2,0,0,0,6,8,14,1248,1191,2439
20172018,65,LEE,321,Lee County,100,Lee County Elementary School,65321100,210327000216,KVEC,904,235,170,405,1,2,3,0,1,1,0,0,0,0,0,0,0,0,0,2,3,5,238,176,414
20172018,65,LEE,321,Lee County,60,Lee County Middle High School,65321060,,KVEC,904,253,245,498,5,1,6,0,1,1,0,0,0,0,1,1,0,0,0,1,1,2,259,249,508
20172018,65,LEE,321,Lee County,,---District Total---,,,KVEC,904,488,415,903,6,3,9,0,2,2,0,0,0,0,1,1,0,0,0,3,4,7,497,425,922
20172018,66,LESLIE,325,Leslie County,280,Hayes Lewis Elementary School,66325280,210333000882,KVEC,904,61,64,125,0,0,0,0,2,2,0,0,0,0,0,0,0,0,0,0,0,0,61,66,127
20172018,66,LESLIE,325,Leslie County,350,Leslie County High School,66325350,210333000885,KVEC,904,250,227,477,4,1,5,1,0,1,0,1,1,0,0,0,0,0,0,0,0,0,255,229,484
20172018,66,LESLIE,325,Leslie County,300,Mountain View Elementary,66325300,210333000883,KVEC,904,252,216,468,4,0,4,1,0,1,1,0,1,0,0,0,0,0,0,3,0,3,261,216,477
20172018,66,LESLIE,325,Leslie County,570,Stinnett Elementary School,66325570,210333000887,KVEC,904,185,164,349,2,2,4,0,0,0,0,0,0,0,0,0,0,0,0,0,1,1,187,167,354
20172018,66,LESLIE,325,Leslie County,420,W B Muncy Elementary School,66325420,210333000886,KVEC,904,114,109,223,0,1,1,0,1,1,0,0,0,0,0,0,0,0,0,0,0,0,114,111,225
20172018,66,LESLIE,325,Leslie County,,---District Total---,,,KVEC,904,862,780,1642,10,4,14,2,3,5,1,1,2,0,0,0,0,0,0,3,1,4,878,789,1667
20172018,67,LETCHER,331,Letcher County,210,Arlie Boggs Elementary School,67331210,210336000892,KVEC,904,69,74,143,0,0,0,0,0,0,0,0,0,1,0,1,0,0,0,0,0,0,70,74,144
20172018,67,LETCHER,331,Letcher County,380,Cowan Elementary School,67331380,210336000900,KVEC,904,157,170,327,0,1,1,1,2,3,0,0,0,1,0,1,0,0,0,2,2,4,161,175,336
20172018,67,LETCHER,331,Letcher County,250,Fleming Neon Middle School,67331250,210336000894,KVEC,904,111,82,193,0,1,1,4,3,7,0,0,0,0,0,0,0,0,0,0,0,0,115,86,201
20172018,67,LETCHER,331,Letcher County,55,Letcher County Alternative Education Ctr,67331055,210336002344,KVEC,904,3,0,3,0,0,0,0,0,0,0,0,0,0,0,0,0,0,0,0,0,0,3,0,3
20172018,67,LETCHER,331,Letcher County,56,Letcher County Central High School,67331056,210336001998,KVEC,904,421,378,799,2,2,4,1,2,3,1,1,2,0,0,0,0,0,0,1,3,4,426,386,812
20172018,67,LETCHER,331,Letcher County,350,Letcher Elementary School,67331350,210336000898,KVEC,904,149,133,282,0,2,2,0,2,2,0,0,0,0,0,0,0,0,0,0,2,2,149,139,288
20172018,67,LETCHER,331,Letcher County,355,Letcher Middle School,67331355,210336002318,KVEC,904,98,73,171,0,0,0,0,0,0,0,0,0,0,0,0,0,0,0,2,0,2,100,73,173
20172018,67,LETCHER,331,Letcher County,425,Martha Jane Potter Elementary School,67331425,210336000901,KVEC,904,198,194,392,0,0,0,3,2,5,0,1,1,0,0,0,0,0,0,2,2,4,203,199,402
20172018,67,LETCHER,331,Letcher County,650,West Whitesburg Elementary School,67331650,210336000903,KVEC,904,217,180,397,0,0,0,1,1,2,0,0,0,0,0,0,0,0,0,1,2,3,219,183,402
20172018,67,LETCHER,331,Letcher County,710,Whitesburg Middle School,67331710,210336000904,KVEC,904,109,99,208,0,0,0,1,0,1,0,2,2,0,0,0,0,0,0,1,1,2,111,102,213
20172018,67,LETCHER,331,Letcher County,,---District Total---,,,KVEC,904,1532,1383,2915,2,6,8,11,12,23,1,4,5,2,0,2,0,0,0,9,12,21,1557,1417,2974
20172018,68,LEWIS,335,Lewis County,970,Foster Meade Career & Technical Center,68335970,210339002377,KEDC,903,0,0,0,0,0,0,0,0,0,0,0,0,0,0,0,0,0,0,0,0,0,0,0,0
20172018,68,LEWIS,335,Lewis County,40,Garrison Elementary School,68335040,210339000906,KEDC,903,140,126,266,1,1,2,0,0,0,0,0,0,0,0,0,0,0,0,4,3,7,145,130,275
20172018,68,LEWIS,335,Lewis County,90,Laurel Elementary School,68335090,210339000908,KEDC,903,36,38,74,0,0,0,0,0,0,0,0,0,0,0,0,0,0,0,1,2,3,37,40,77
20172018,68,LEWIS,335,Lewis County,95,Lewis County Central Elementary School,68335095,210339000909,KEDC,903,223,199,422,0,1,1,0,1,1,0,0,0,0,0,0,0,0,0,9,3,12,232,204,436
20172018,68,LEWIS,335,Lewis County,120,Lewis County High School,68335120,210339000910,KEDC,903,325,322,647,2,1,3,1,1,2,0,2,2,0,0,0,0,0,0,8,9,17,336,335,671
20172018,68,LEWIS,335,Lewis County,100,Lewis County Middle School,68335100,210339001503,KEDC,903,197,197,394,1,2,3,0,4,4,0,0,0,0,0,0,0,0,0,3,6,9,201,209,410
20172018,68,LEWIS,335,Lewis County,140,Tollesboro Elementary School,68335140,210339000911,KEDC,903,146,137,283,0,0,0,1,1,2,0,0,0,0,0,0,0,0,0,1,2,3,148,140,288
20172018,68,LEWIS,335,Lewis County,,---District Total---,,,KEDC,903,1067,1019,2086,4,5,9,2,7,9,0,2,2,0,0,0,0,0,0,26,25,51,1099,1058,2157
20172018,69,LINCOLN,341,Lincoln County,40,Crab Orchard Elementary School,69341040,210348000914,SESC,907,119,101,220,0,0,0,10,5,15,0,0,0,1,0,1,0,0,0,4,3,7,134,109,243
20172018,69,LINCOLN,341,Lincoln County,21,Fort Logan School,69341021,210348001643,SESC,907,29,23,52,0,0,0,2,0,2,0,0,0,0,0,0,0,0,0,1,1,2,32,24,56
20172018,69,LINCOLN,341,Lincoln County,50,Highland Elementary School,69341050,210348000915,SESC,907,115,114,229,0,0,0,3,3,6,0,0,0,0,2,2,0,0,0,2,0,2,120,119,239
20172018,69,LINCOLN,341,Lincoln County,70,Hustonville Elementary School,69341070,210348000916,SESC,907,135,126,261,1,0,1,3,4,7,1,0,1,0,1,1,0,0,0,2,6,8,142,137,279
20172018,69,LINCOLN,341,Lincoln County,95,Lincoln County High School,69341095,210348000918,SESC,907,505,454,959,7,9,16,12,19,31,2,3,5,0,0,0,0,1,1,21,16,37,547,502,1049
20172018,69,LINCOLN,341,Lincoln County,65,Lincoln County Middle School,69341065,210348000478,SESC,907,380,392,772,6,6,12,23,15,38,0,4,4,2,0,2,0,0,0,15,10,25,426,427,853
20172018,69,LINCOLN,341,Lincoln County,100,McKinney Elementary School,69341100,210348000919,SESC,907,63,56,119,1,0,1,3,2,5,0,0,0,1,0,1,0,0,0,4,3,7,72,61,133
20172018,69,LINCOLN,341,Lincoln County,130,Stanford Elementary School,69341130,210348000920,SESC,907,247,207,454,14,12,26,17,10,27,1,1,2,0,0,0,0,0,0,17,12,29,296,242,538
20172018,69,LINCOLN,341,Lincoln County,150,Waynesburg Elementary School,69341150,210348000921,SESC,907,120,119,239,0,0,0,4,6,10,0,0,0,0,0,0,0,0,0,2,3,5,126,128,254
20172018,69,LINCOLN,341,Lincoln County,,---District Total---,,,SESC,907,1713,1592,3305,29,27,56,77,64,141,4,8,12,4,3,7,0,1,1,68,54,122,1895,1749,3644
20172018,70,LIVINGSTON,345,Livingston County,50,Livingston Central High School,70345050,210351000924,WKEC,908,157,150,307,2,0,2,3,5,8,1,1,2,0,0,0,0,0,0,2,0,2,165,156,321
20172018,70,LIVINGSTON,345,Livingston County,65,Livingston County Middle School,70345065,210351001484,WKEC,908,117,123,240,1,0,1,5,6,11,0,0,0,0,0,0,0,1,1,3,5,8,126,135,261
20172018,70,LIVINGSTON,345,Livingston County,20,North Livingston Elementary School,70345020,210351001133,WKEC,908,64,85,149,3,0,3,3,2,5,3,0,3,0,0,0,0,0,0,6,4,10,79,91,170
20172018,70,LIVINGSTON,345,Livingston County,21,South Livingston Elementary School,70345021,210351001999,WKEC,908,178,133,311,0,1,1,9,15,24,1,1,2,0,0,0,0,0,0,11,8,19,199,158,357
20172018,70,LIVINGSTON,345,Livingston County,,---District Total---,,,WKEC,908,516,491,1007,6,1,7,20,28,48,5,2,7,0,0,0,0,1,1,22,17,39,569,540,1109
20172018,71,LOGAN,351,Logan County,11,Adairville Elementary School,71351011,210354001542,GRREC,902,147,124,271,22,14,36,24,12,36,0,0,0,1,1,2,0,0,0,2,3,5,196,154,350
20172018,71,LOGAN,351,Logan County,12,Auburn Elementary School,71351012,210354001543,GRREC,902,315,291,606,6,6,12,13,9,22,0,0,0,0,0,0,0,0,0,19,10,29,353,316,669
20172018,71,LOGAN,351,Logan County,13,Chandlers Elementary School,71351013,210354001544,GRREC,902,212,201,413,3,1,4,8,6,14,0,1,1,0,0,0,0,0,0,6,8,14,229,217,446
20172018,71,LOGAN,351,Logan County,14,Lewisburg Elementary School,71351014,210354001545,GRREC,902,240,219,459,2,1,3,11,11,22,0,0,0,0,0,0,0,0,0,7,4,11,260,235,495
20172018,71,LOGAN,351,Logan County,30,Logan County Alternative School,71351030,210354002396,GRREC,902,0,0,0,0,0,0,0,0,0,0,0,0,0,0,0,0,0,0,0,0,0,0,0,0
20172018,71,LOGAN,351,Logan County,140,Logan County High School,71351140,210354001458,GRREC,902,501,490,991,20,20,40,15,13,28,0,2,2,2,0,2,0,0,0,14,13,27,552,538,1090
20172018,71,LOGAN,351,Logan County,16,Olmstead Elementary School,71351016,210354001546,GRREC,902,165,195,360,1,7,8,2,2,4,1,1,2,0,0,0,1,0,1,5,10,15,175,215,390
20172018,71,LOGAN,351,Logan County,,---District Total---,,,GRREC,902,1580,1520,3100,54,49,103,73,53,126,1,4,5,3,1,4,1,0,1,53,48,101,1765,1675,3440
20172018,59,KENTON,354,Ludlow Independent,20,Ludlow High School,59354020,210363000939,NKCES,905,179,154,333,2,2,4,6,5,11,1,2,3,0,0,0,0,0,0,10,4,14,198,167,365
20172018,59,KENTON,354,Ludlow Independent,10,Mary A. Goetz Elementary School,59354010,210363000938,NKCES,905,162,198,360,2,3,5,4,7,11,2,1,3,0,0,0,1,0,1,13,15,28,184,224,408
20172018,59,KENTON,354,Ludlow Independent,,---District Total---,,,NKCES,905,341,352,693,4,5,9,10,12,22,3,3,6,0,0,0,1,0,1,23,19,42,382,391,773
20172018,72,LYON,361,Lyon County,20,Lyon County Elementary School,72361020,210369000942,WKEC,908,195,152,347,7,2,9,11,6,17,2,1,3,2,1,3,1,1,2,8,9,17,226,172,398
20172018,72,LYON,361,Lyon County,70,Lyon County High School,72361070,210369000943,WKEC,908,123,126,249,1,3,4,3,3,6,0,2,2,0,0,0,0,0,0,2,5,7,129,139,268
20172018,72,LYON,361,Lyon County,23,Lyon County Middle School,72361023,210369001950,WKEC,908,97,92,189,3,4,7,8,4,12,3,2,5,1,0,1,0,1,1,4,2,6,116,105,221
20172018,72,LYON,361,Lyon County,,---District Total---,,,WKEC,908,415,370,785,11,9,20,22,13,35,5,5,10,3,1,4,1,2,3,14,16,30,471,416,887
20172018,73,MADISON,365,Madison County,21,B. Michael Caudill Middle School,73365021,210372002217,SESC,907,281,264,545,15,6,21,20,18,38,1,2,3,0,1,1,0,0,0,19,14,33,336,305,641
20172018,73,MADISON,365,Madison County,8,Boonesborough Elementary,73365008,,SESC,907,0,0,0,0,0,0,0,0,0,0,0,0,0,0,0,0,0,0,0,0,0,0,0,0
20172018,73,MADISON,365,Madison County,465,Burrier Preschool,73365465,,SESC,907,0,0,0,0,0,0,0,0,0,0,0,0,0,0,0,0,0,0,0,0,0,0,0,0
20172018,73,MADISON,365,Madison County,10,Clark Moores Middle School,73365010,210372000944,SESC,907,241,209,450,6,3,9,15,10,25,5,0,5,0,0,0,0,0,0,15,18,33,282,240,522
20172018,73,MADISON,365,Madison County,15,Daniel Boone Elementary School,73365015,210372000945,SESC,907,169,175,344,21,32,53,23,17,40,5,4,9,1,0,1,0,0,0,12,22,34,231,250,481
20172018,73,MADISON,365,Madison County,145,Farristown Middle School,73365145,210372002311,SESC,907,230,214,444,2,3,5,7,8,15,0,1,1,0,0,0,0,0,0,2,7,9,241,233,474
20172018,73,MADISON,365,Madison County,140,Foley Middle School,73365140,210372000953,SESC,907,225,188,413,5,2,7,13,7,20,2,2,4,0,0,0,0,0,0,7,5,12,252,204,456
20172018,73,MADISON,365,Madison County,18,Glenn R Marshall Elementary School,73365018,210372002032,SESC,907,181,155,336,9,7,16,15,6,21,1,0,1,0,0,0,0,0,0,10,17,27,216,185,401
20172018,73,MADISON,365,Madison County,30,Kingston Elementary School,73365030,210372000946,SESC,907,270,240,510,3,4,7,6,8,14,0,0,0,0,0,0,0,0,0,5,10,15,284,262,546
20172018,73,MADISON,365,Madison County,40,Kirksville Elementary School,73365040,210372000947,SESC,907,205,197,402,22,18,40,37,21,58,1,0,1,0,0,0,0,0,0,20,19,39,285,255,540
20172018,73,MADISON,365,Madison County,45,Kit Carson Elementary School,73365045,210372000948,SESC,907,228,251,479,16,11,27,16,14,30,7,4,11,0,0,0,0,2,2,14,21,35,281,303,584
20172018,73,MADISON,365,Madison County,50,Madison Central High School,73365050,210372000949,SESC,907,783,790,1573,64,75,139,50,54,104,12,16,28,4,4,8,1,0,1,49,37,86,963,976,1939
20172018,73,MADISON,365,Madison County,160,Madison County Day Treatment,73365160,210372001678,SESC,907,11,6,17,3,0,3,0,1,1,0,0,0,0,0,0,0,0,0,1,0,1,15,7,22
20172018,73,MADISON,365,Madison County,110,Madison Kindergarten Academy,73365110,210372002392,SESC,907,151,148,299,10,14,24,13,6,19,3,0,3,0,1,1,0,0,0,13,10,23,190,179,369
20172018,73,MADISON,365,Madison County,20,Madison Middle School,73365020,210372000250,SESC,907,175,173,348,23,20,43,21,13,34,6,3,9,1,1,2,1,1,2,16,25,41,243,236,479
20172018,73,MADISON,365,Madison County,150,Madison Southern High School,73365150,210372001594,SESC,907,547,547,1094,6,5,11,18,17,35,7,2,9,0,2,2,0,0,0,15,13,28,593,586,1179
20172018,73,MADISON,365,Madison County,450,Model Laboratory Elementary School,73365450,210372001485,SESC,907,135,130,265,1,4,5,1,1,2,5,6,11,1,1,2,0,0,0,2,3,5,145,145,290
20172018,73,MADISON,365,Madison County,460,Model Laboratory High School,73365460,210372001486,SESC,907,110,79,189,2,2,4,0,2,2,7,13,20,1,0,1,0,0,0,3,4,7,123,100,223
20172018,73,MADISON,365,Madison County,455,Model Laboratory Middle School,73365455,210372001536,SESC,907,80,73,153,0,3,3,2,2,4,4,4,8,0,1,1,0,0,0,4,4,8,90,87,177
20172018,73,MADISON,365,Madison County,7,Shannon Johnson Elementary School,73365007,210372001901,SESC,907,250,279,529,3,3,6,8,12,20,2,3,5,0,1,1,0,0,0,14,13,27,277,311,588
20172018,73,MADISON,365,Madison County,100,Silver Creek Elementary School,73365100,210372000950,SESC,907,202,233,435,3,0,3,5,3,8,2,0,2,0,2,2,0,0,0,6,11,17,218,249,467
20172018,73,MADISON,365,Madison County,120,Waco Elementary School,73365120,210372000951,SESC,907,234,190,424,3,3,6,4,1,5,0,1,1,0,0,0,0,2,2,7,8,15,248,205,453
20172018,73,MADISON,365,Madison County,130,White Hall Elementary School,73365130,210372000952,SESC,907,248,259,507,9,7,16,14,6,20,1,0,1,0,0,0,0,0,0,17,14,31,289,286,575
20172018,73,MADISON,365,Madison County,,---District Total---,,,SESC,907,4956,4800,9756,226,222,448,288,227,515,71,61,132,8,14,22,2,5,7,251,275,526,5802,5604,11406
20172018,74,MAGOFFIN,371,Magoffin County,175,Herald Whitaker Middle School,74371175,210375001618,KVEC,904,241,238,479,0,0,0,2,1,3,0,0,0,0,0,0,0,0,0,0,1,1,243,240,483
20172018,74,MAGOFFIN,371,Magoffin County,370,Magoffin County High School,74371370,210375000960,KVEC,904,324,261,585,0,0,0,1,0,1,0,0,0,0,0,0,0,0,0,0,0,0,325,261,586
20172018,74,MAGOFFIN,371,Magoffin County,172,North Magoffin Elementary,74371172,210375002238,KVEC,904,183,179,362,0,0,0,1,0,1,0,0,0,0,0,0,0,0,0,2,0,2,186,179,365
20172018,74,MAGOFFIN,371,Magoffin County,360,Salyersville Grade School,74371360,210375000958,KVEC,904,209,181,390,1,0,1,2,1,3,0,0,0,0,0,0,0,1,1,6,0,6,218,183,401
20172018,74,MAGOFFIN,371,Magoffin County,173,South Magoffin Elementary,74371173,210375002227,KVEC,904,90,72,162,0,0,0,1,1,2,0,0,0,0,0,0,0,0,0,2,1,3,93,74,167
20172018,74,MAGOFFIN,371,Magoffin County,,---District Total---,,,KVEC,904,1047,931,1978,1,0,1,7,3,10,0,0,0,0,0,0,0,1,1,10,2,12,1065,937,2002
20172018,75,MARION,375,Marion County,20,Calvary Elementary School,75375020,210378000962,CKEC,901,109,111,220,3,0,3,3,4,7,0,0,0,0,0,0,0,0,0,3,2,5,118,117,235
20172018,75,MARION,375,Marion County,40,Glasscock Elementary School,75375040,210378000963,CKEC,901,162,167,329,31,22,53,13,17,30,1,0,1,0,0,0,0,0,0,9,11,20,216,217,433
20172018,75,MARION,375,Marion County,30,Hugh C. Spalding Academy,75375030,210378002328,CKEC,901,24,22,46,7,3,10,1,0,1,0,0,0,0,0,0,0,0,0,0,0,0,32,25,57
20172018,75,MARION,375,Marion County,210,Lebanon Elementary School,75375210,210378000967,CKEC,901,108,122,230,19,25,44,36,19,55,1,3,4,0,0,0,1,1,2,19,16,35,184,186,370
20172018,75,MARION,375,Marion County,515,Marion County High School,75375515,210378000970,CKEC,901,292,272,564,22,19,41,8,14,22,4,4,8,0,0,0,0,0,0,1,1,2,327,310,637
20172018,75,MARION,375,Marion County,85,Marion County Knight Academy,75375085,,CKEC,901,203,216,419,12,22,34,13,17,30,2,4,6,0,0,0,0,0,0,1,2,3,231,261,492
20172018,75,MARION,375,Marion County,95,Marion County Middle School,75375095,,CKEC,901,209,202,411,17,14,31,13,7,20,1,1,2,0,0,0,0,0,0,3,4,7,243,228,471
20172018,75,MARION,375,Marion County,100,West Marion Elementary School,75375100,210378001619,CKEC,901,224,198,422,1,4,5,4,0,4,0,0,0,1,0,1,0,0,0,1,0,1,231,202,433
20172018,75,MARION,375,Marion County,,---District Total---,,,CKEC,901,1331,1310,2641,112,109,221,91,78,169,9,12,21,1,0,1,1,1,2,37,36,73,1582,1546,3128
20172018,76,MARSHALL,381,Marshall County,11,Benton Elementary School,76381011,210381000971,WKEC,908,251,227,478,0,0,0,7,8,15,4,3,7,0,0,0,0,0,0,4,4,8,266,242,508
20172018,76,MARSHALL,381,Marshall County,40,Calvert City Elementary School,76381040,210381000973,WKEC,908,147,116,263,0,1,1,4,4,8,2,1,3,0,0,0,1,1,2,5,5,10,159,128,287
20172018,76,MARSHALL,381,Marshall County,10,Central Elementary School,76381010,210381000272,WKEC,908,235,247,482,0,0,0,5,5,10,1,0,1,0,0,0,0,0,0,1,2,3,242,254,496
20172018,76,MARSHALL,381,Marshall County,85,Jonathan Elementary School,76381085,210381000975,WKEC,908,103,87,190,0,0,0,3,1,4,0,0,0,0,0,0,0,0,0,2,2,4,108,90,198
20172018,76,MARSHALL,381,Marshall County,88,Marshall County High School,76381088,210381000976,WKEC,908,691,604,1295,0,1,1,11,10,21,1,4,5,0,2,2,0,1,1,5,10,15,708,632,1340
20172018,76,MARSHALL,381,Marshall County,904,Marshall County Technical Center,76381904,210381001509,WKEC,908,0,0,0,0,0,0,0,0,0,0,0,0,0,0,0,0,0,0,0,0,0,0,0,0
20172018,76,MARSHALL,381,Marshall County,90,North Marshall Middle School,76381090,210381000977,WKEC,908,298,244,542,0,0,0,8,4,12,1,3,4,0,1,1,0,0,0,1,3,4,308,255,563
20172018,76,MARSHALL,381,Marshall County,5,Purchase Youth Village,76381005,,WKEC,908,5,7,12,3,1,4,0,1,1,0,0,0,0,0,0,0,1,1,1,1,2,9,11,20
20172018,76,MARSHALL,381,Marshall County,100,Sharpe Elementary School,76381100,210381000978,WKEC,908,151,137,288,1,0,1,1,5,6,0,1,1,1,0,1,0,0,0,1,8,9,155,151,306
20172018,76,MARSHALL,381,Marshall County,105,South Marshall Elementary School,76381105,210381000979,WKEC,908,146,140,286,1,0,1,3,3,6,0,0,0,0,0,0,0,0,0,1,0,1,151,143,294
20172018,76,MARSHALL,381,Marshall County,111,South Marshall Middle,76381111,,WKEC,908,245,271,516,3,0,3,4,10,14,2,2,4,0,0,0,0,0,0,2,4,6,256,287,543
20172018,76,MARSHALL,381,Marshall County,18,Star Academy High School,76381018,210381002073,WKEC,908,13,13,26,0,0,0,0,0,0,0,0,0,0,0,0,0,0,0,0,0,0,13,13,26
20172018,76,MARSHALL,381,Marshall County,,---District Total---,,,WKEC,908,2285,2093,4378,8,3,11,46,51,97,11,14,25,1,3,4,1,3,4,23,39,62,2375,2206,4581
20172018,77,MARTIN,385,Martin County,51,Eden Elementary School,77385051,210384001902,KEDC,903,161,154,315,1,1,2,0,0,0,0,0,0,0,0,0,0,0,0,0,0,0,162,155,317
20172018,77,MARTIN,385,Martin County,120,Inez Elementary School,77385120,210384000982,KEDC,903,135,125,260,1,1,2,1,1,2,0,2,2,0,0,0,0,0,0,0,1,1,137,130,267
20172018,77,MARTIN,385,Martin County,330,Martin County Middle School,77385330,210384002386,KEDC,903,219,169,388,0,0,0,0,0,0,0,0,0,0,0,0,0,0,0,0,0,0,219,169,388
20172018,77,MARTIN,385,Martin County,250,Sheldon Clark High School,77385250,210384000985,KEDC,903,278,235,513,1,3,4,1,1,2,0,0,0,0,0,0,0,0,0,0,0,0,280,239,519
20172018,77,MARTIN,385,Martin County,300,Warfield Elementary School,77385300,210384000988,KEDC,903,152,130,282,0,0,0,1,0,1,0,0,0,0,0,0,0,0,0,2,0,2,155,130,285
20172018,77,MARTIN,385,Martin County,,---District Total---,,,KEDC,903,945,813,1758,3,5,8,3,2,5,0,2,2,0,0,0,0,0,0,2,1,3,953,823,1776
20172018,78,MASON,391,Mason County,80,Charles Straub Elementary School,78391080,210387001460,KEDC,903,229,231,460,13,21,34,16,13,29,1,4,5,1,1,2,0,0,0,21,27,48,281,297,578
20172018,78,MASON,391,Mason County,30,Mason County High School,78391030,210387000989,KEDC,903,308,328,636,32,36,68,11,14,25,0,3,3,1,0,1,0,0,0,19,14,33,371,395,766
20172018,78,MASON,391,Mason County,11,Mason County Intermediate School,78391011,210387002000,KEDC,903,294,256,550,25,27,52,12,13,25,5,1,6,0,1,1,0,0,0,23,36,59,359,334,693
20172018,78,MASON,391,Mason County,50,Mason County Middle School,78391050,210387000991,KEDC,903,264,226,490,16,27,43,14,11,25,1,0,1,2,1,3,0,0,0,18,16,34,315,281,596
20172018,78,MASON,391,Mason County,,---District Total---,,,KEDC,903,1095,1041,2136,86,111,197,53,51,104,7,8,15,4,3,7,0,0,0,81,93,174,1326,1307,2633
20172018,42,GRAVES,392,Mayfield Independent,31,Mayfield Elementary School,42392031,210390002001,WKEC,908,158,163,321,50,73,123,128,117,245,3,0,3,0,0,0,2,0,2,35,39,74,376,392,768
20172018,42,GRAVES,392,Mayfield Independent,60,Mayfield High School,42392060,210390000995,WKEC,908,110,111,221,40,39,79,61,61,122,2,1,3,0,0,0,0,1,1,21,21,42,234,234,468
20172018,42,GRAVES,392,Mayfield Independent,65,Mayfield Middle School,42392065,210390000996,WKEC,908,119,110,229,42,47,89,77,67,144,0,2,2,0,0,0,0,0,0,33,35,68,271,261,532
20172018,42,GRAVES,392,Mayfield Independent,,---District Total---,,,WKEC,908,387,384,771,132,159,291,266,245,511,5,3,8,0,0,0,2,1,3,89,95,184,881,887,1768
20172018,79,MCCRACKEN,395,McCracken County,10,Concord Elementary School,79395010,210396001001,WKEC,908,263,236,499,20,15,35,10,8,18,4,6,10,0,1,1,0,0,0,16,12,28,313,278,591
20172018,79,MCCRACKEN,395,McCracken County,120,Heath Elementary School,79395120,210396001461,WKEC,908,191,170,361,3,2,5,6,6,12,1,2,3,0,0,0,1,0,1,7,8,15,209,188,397
20172018,79,MCCRACKEN,395,McCracken County,55,Heath Middle School,79395055,210396001006,WKEC,908,213,203,416,11,5,16,9,10,19,3,2,5,1,2,3,0,0,0,10,8,18,247,230,477
20172018,79,MCCRACKEN,395,McCracken County,65,Hendron Lone Oak Elementary School,79395065,210396001431,WKEC,908,189,143,332,13,7,20,7,9,16,4,3,7,1,0,1,0,0,0,7,9,16,221,171,392
20172018,79,MCCRACKEN,395,McCracken County,80,Lone Oak Elementary School,79395080,210396001009,WKEC,908,225,201,426,26,13,39,14,10,24,3,3,6,1,0,1,0,0,0,14,14,28,283,241,524
20172018,79,MCCRACKEN,395,McCracken County,75,Lone Oak Intermediate School,79395075,210396002374,WKEC,908,210,212,422,15,19,34,2,15,17,2,7,9,0,0,0,3,0,3,12,6,18,244,259,503
20172018,79,MCCRACKEN,395,McCracken County,85,Lone Oak Middle School,79395085,210396001010,WKEC,908,343,291,634,22,25,47,28,15,43,7,6,13,1,0,1,0,1,1,16,15,31,417,353,770
20172018,79,MCCRACKEN,395,McCracken County,15,McCracken County High School,79395015,210396002332,WKEC,908,830,854,1684,44,41,85,40,45,85,13,10,23,1,2,3,1,2,3,33,26,59,962,980,1942
20172018,79,MCCRACKEN,395,McCracken County,12,McCracken Open Campus School,79395012,210396001801,WKEC,908,66,29,95,4,4,8,3,2,5,0,0,0,0,0,0,0,0,0,3,4,7,76,39,115
20172018,79,MCCRACKEN,395,McCracken County,13,McCracken Regional School,79395013,210396001862,WKEC,908,11,2,13,10,1,11,1,0,1,0,0,0,0,0,0,0,0,0,3,2,5,25,5,30
20172018,79,MCCRACKEN,395,McCracken County,100,Reidland Elementary School,79395100,210396001011,WKEC,908,196,206,402,4,11,15,8,12,20,2,3,5,1,0,1,0,0,0,17,15,32,228,247,475
20172018,79,MCCRACKEN,395,McCracken County,30,Reidland Intermediate School,79395030,210396002419,WKEC,908,98,102,200,4,6,10,9,6,15,1,0,1,0,2,2,0,0,0,6,9,15,118,125,243
20172018,79,MCCRACKEN,395,McCracken County,115,Reidland Middle School,79395115,210396001013,WKEC,908,153,141,294,9,8,17,3,12,15,2,1,3,1,0,1,0,0,0,8,5,13,176,167,343
20172018,79,MCCRACKEN,395,McCracken County,,---District Total---,,,WKEC,908,2988,2790,5778,185,157,342,140,150,290,42,43,85,7,7,14,5,3,8,152,133,285,3519,3283,6802
20172018,80,MCCREARY,401,McCreary County,12,McCreary Academy,80401012,210399001805,SESC,907,41,22,63,3,1,4,0,0,0,0,0,0,0,0,0,0,0,0,0,0,0,44,23,67
20172018,80,MCCREARY,401,McCreary County,10,McCreary Central High School,80401010,210399001014,SESC,907,384,326,710,5,5,10,7,4,11,1,0,1,1,0,1,0,0,0,2,1,3,400,336,736
20172018,80,MCCREARY,401,McCreary County,14,McCreary County Middle School,80401014,210399002002,SESC,907,210,204,414,0,0,0,3,0,3,0,0,0,0,0,0,0,0,0,2,0,2,215,204,419
20172018,80,MCCREARY,401,McCreary County,13,Pine Knot Career Institute,80401013,210399001863,SESC,907,0,0,0,0,0,0,0,0,0,0,0,0,0,0,0,0,0,0,0,0,0,0,0,0
20172018,80,MCCREARY,401,McCreary County,20,Pine Knot Elementary School,80401020,,SESC,907,490,408,898,3,1,4,2,3,5,2,0,2,0,0,0,0,0,0,2,1,3,499,413,912
20172018,80,MCCREARY,401,McCreary County,330,Whitley City Elementary School,80401330,210399001021,SESC,907,276,302,578,0,0,0,4,7,11,0,0,0,0,0,0,0,0,0,4,0,4,284,309,593
20172018,80,MCCREARY,401,McCreary County,,---District Total---,,,SESC,907,1401,1262,2663,11,7,18,16,14,30,3,0,3,1,0,1,0,0,0,10,2,12,1442,1285,2727
20172018,81,MCLEAN,405,McLean County,20,Calhoun Elementary School,81405020,210402001023,GRREC,902,160,161,321,0,0,0,3,11,14,0,0,0,0,0,0,0,0,0,0,0,0,163,172,335
20172018,81,MCLEAN,405,McLean County,50,Livermore Elementary School,81405050,210402001025,GRREC,902,108,110,218,2,3,5,10,6,16,1,0,1,0,0,0,0,0,0,1,3,4,122,122,244
20172018,81,MCLEAN,405,McLean County,70,Marie Gatton Phillips Elementary,81405070,210402001027,GRREC,902,70,39,109,0,0,0,0,1,1,0,0,0,0,0,0,0,0,0,2,0,2,72,40,112
20172018,81,MCLEAN,405,McLean County,65,McLean County High School,81405065,210402001026,GRREC,902,237,210,447,5,3,8,12,2,14,0,1,1,0,0,0,0,0,0,3,0,3,257,216,473
20172018,81,MCLEAN,405,McLean County,75,McLean County Middle School,81405075,210402001140,GRREC,902,154,166,320,2,1,3,5,8,13,1,0,1,0,0,0,0,0,0,2,0,2,164,175,339
20172018,81,MCLEAN,405,McLean County,,---District Total---,,,GRREC,902,729,686,1415,9,7,16,30,28,58,2,1,3,0,0,0,0,0,0,8,3,11,778,725,1503
20172018,82,MEADE,411,Meade County,12,Brandenburg High School,82411012,210405001930,GRREC,902,1,2,3,0,0,0,0,0,0,0,0,0,0,0,0,0,0,0,0,0,0,1,2,3
20172018,82,MEADE,411,Meade County,60,Brandenburg Primary School,82411060,210405001034,GRREC,902,300,273,573,8,8,16,11,13,24,3,1,4,1,0,1,0,0,0,15,21,36,338,316,654
20172018,82,MEADE,411,Meade County,11,David T. Wilson Elementary,82411011,210405001644,GRREC,902,237,192,429,0,1,1,7,7,14,0,1,1,0,0,0,0,0,0,18,16,34,262,217,479
20172018,82,MEADE,411,Meade County,40,Ekron Elementary School,82411040,210405001032,GRREC,902,169,149,318,4,2,6,3,7,10,0,1,1,0,0,0,0,0,0,6,3,9,182,162,344
20172018,82,MEADE,411,Meade County,50,Flaherty Elementary School,82411050,210405001033,GRREC,902,138,141,279,7,3,10,5,7,12,1,1,2,0,0,0,0,0,0,7,18,25,158,170,328
20172018,82,MEADE,411,Meade County,30,Flaherty Primary School,82411030,210405002295,GRREC,902,179,163,342,5,5,10,5,13,18,3,3,6,0,0,0,0,0,0,17,17,34,209,201,410
20172018,82,MEADE,411,Meade County,13,James R. Allen High School,82411013,210405002202,GRREC,902,10,5,15,0,0,0,1,0,1,0,0,0,0,0,0,0,0,0,1,0,1,12,5,17
20172018,82,MEADE,411,Meade County,70,Meade County High School,82411070,210405001035,GRREC,902,733,663,1396,22,10,32,27,23,50,1,6,7,3,2,5,0,1,1,26,21,47,812,726,1538
20172018,82,MEADE,411,Meade County,90,Payneville Elementary School,82411090,210405001037,GRREC,902,115,97,212,0,0,0,3,4,7,0,0,0,0,0,0,1,1,2,4,0,4,123,102,225
20172018,82,MEADE,411,Meade County,15,Stuart Pepper Middle School,82411015,210405001029,GRREC,902,373,364,737,4,2,6,17,4,21,2,2,4,0,1,1,2,1,3,10,12,22,408,386,794
20172018,82,MEADE,411,Meade County,,---District Total---,,,GRREC,902,2255,2049,4304,50,31,81,79,78,157,10,15,25,4,3,7,3,3,6,104,108,212,2505,2287,4792
20172018,83,MENIFEE,415,Menifee County,20,Botts Elementary School,83415020,210408001038,KEDC,903,90,99,189,0,0,0,3,6,9,0,0,0,0,0,0,0,0,0,1,1,2,94,106,200
20172018,83,MENIFEE,415,Menifee County,21,Menifee Co. Academy Alternative School,83415021,210408001864,KEDC,903,8,6,14,11,1,12,4,0,4,0,0,0,0,0,0,0,0,0,0,0,0,23,7,30
20172018,83,MENIFEE,415,Menifee County,90,Menifee County High School,83415090,210408001040,KEDC,903,158,142,300,0,3,3,3,3,6,0,1,1,0,0,0,0,0,0,2,1,3,163,150,313
20172018,83,MENIFEE,415,Menifee County,80,Menifee Elementary School,83415080,210408001039,KEDC,903,229,222,451,2,1,3,5,2,7,0,0,0,0,0,0,0,1,1,2,3,5,238,229,467
20172018,83,MENIFEE,415,Menifee County,,---District Total---,,,KEDC,903,485,469,954,13,5,18,15,11,26,0,1,1,0,0,0,0,1,1,5,5,10,518,492,1010
20172018,84,MERCER,421,Mercer County,35,Kenneth D. King Middle School,84421035,210411000482,CKEC,901,246,235,481,9,9,18,17,28,45,0,3,3,0,0,0,0,0,0,22,18,40,294,293,587
20172018,84,MERCER,421,Mercer County,40,Mercer Central,84421040,210411002285,CKEC,901,14,9,23,0,0,0,1,1,2,0,0,0,0,0,0,0,0,0,0,0,0,15,10,25
20172018,84,MERCER,421,Mercer County,27,Mercer County Day Treatment,84421027,210411001491,CKEC,901,3,1,4,0,0,0,0,0,0,0,0,0,0,0,0,0,0,0,5,0,5,8,1,9
20172018,84,MERCER,421,Mercer County,70,Mercer County Elementary School,84421070,210411001042,CKEC,901,265,256,521,8,7,15,15,12,27,2,3,5,1,0,1,1,0,1,19,20,39,311,298,609
20172018,84,MERCER,421,Mercer County,50,Mercer County Intermediate School,84421050,210411002273,CKEC,901,265,265,530,14,18,32,32,19,51,4,2,6,0,0,0,1,0,1,29,12,41,345,316,661
20172018,84,MERCER,421,Mercer County,15,Mercer County Senior High School,84421015,210411002168,CKEC,901,362,320,682,18,24,42,17,19,36,5,3,8,1,0,1,1,0,1,9,21,30,413,387,800
20172018,84,MERCER,421,Mercer County,,---District Total---,,,CKEC,901,1155,1086,2241,49,58,107,82,79,161,11,11,22,2,0,2,3,0,3,84,71,155,1386,1305,2691
20172018,85,METCALFE,425,Metcalfe County,60,Metcalfe County Elementary School,85425060,210414002383,GRREC,902,360,290,650,3,3,6,11,21,32,2,0,2,0,0,0,0,0,0,3,2,5,379,316,695
20172018,85,METCALFE,425,Metcalfe County,50,Metcalfe County High School,85425050,210414001044,GRREC,902,240,214,454,6,5,11,7,4,11,0,1,1,0,0,0,0,0,0,2,0,2,255,224,479
20172018,85,METCALFE,425,Metcalfe County,10,Metcalfe County Middle School,85425010,210414000729,GRREC,902,169,158,327,1,0,1,3,4,7,0,1,1,0,0,0,0,0,0,2,1,3,175,164,339
20172018,85,METCALFE,425,Metcalfe County,,---District Total---,,,GRREC,902,769,662,1431,10,8,18,21,29,50,2,2,4,0,0,0,0,0,0,7,3,10,809,704,1513
20172018,7,BELL,426,Middlesboro Independent,23,Middlesboro Alternative School,7426023,210417001680,SESC,907,23,7,30,6,2,8,1,0,1,0,0,0,0,0,0,0,0,0,0,0,0,30,9,39
20172018,7,BELL,426,Middlesboro Independent,30,Middlesboro Elementary School,7426030,210417001048,SESC,907,169,153,322,10,12,22,3,2,5,3,0,3,1,1,2,0,1,1,22,17,39,208,186,394
20172018,7,BELL,426,Middlesboro Independent,80,Middlesboro High School,7426080,210417001050,SESC,907,163,156,319,14,10,24,1,3,4,3,1,4,0,0,0,0,1,1,6,3,9,187,174,361
20172018,7,BELL,426,Middlesboro Independent,40,Middlesboro Middle School,7426040,210417001049,SESC,907,150,153,303,13,7,20,0,3,3,0,2,2,2,0,2,0,0,0,6,5,11,171,170,341
20172018,7,BELL,426,Middlesboro Independent,,---District Total---,,,SESC,907,505,469,974,43,31,74,5,8,13,6,3,9,3,1,4,0,2,2,34,25,59,596,539,1135
20172018,86,MONROE,431,Monroe County,150,Gamaliel Elementary,86431150,210420001052,GRREC,902,101,93,194,0,0,0,15,7,22,0,0,0,0,2,2,0,0,0,0,0,0,116,102,218
20172018,86,MONROE,431,Monroe County,212,Joe Harrison Carter,86431212,210420001054,GRREC,902,111,114,225,0,0,0,9,2,11,1,0,1,0,0,0,0,0,0,1,0,1,122,116,238
20172018,86,MONROE,431,Monroe County,450,Monroe Co High,86431450,210420001056,GRREC,902,266,240,506,7,6,13,15,9,24,1,1,2,1,0,1,0,0,0,6,3,9,296,259,555
20172018,86,MONROE,431,Monroe County,160,Monroe Co Middle,86431160,210420001053,GRREC,902,208,157,365,3,3,6,18,18,36,1,0,1,0,2,2,0,0,0,5,7,12,235,187,422
20172018,86,MONROE,431,Monroe County,440,Tompkinsville Elem,86431440,210420001055,GRREC,902,168,132,300,7,5,12,17,14,31,0,0,0,0,1,1,0,0,0,4,6,10,196,158,354
20172018,86,MONROE,431,Monroe County,,---District Total---,,,GRREC,902,854,736,1590,17,14,31,74,50,124,3,1,4,1,5,6,0,0,0,16,16,32,965,822,1787
20172018,87,MONTGOMERY,435,Montgomery County,10,Camargo Elementary School,87435010,210425001057,CKEC,901,243,213,456,1,1,2,9,10,19,2,1,3,0,1,1,0,0,0,3,4,7,258,230,488
20172018,87,MONTGOMERY,435,Montgomery County,14,Gateway Children's Services,87435014,210425001868,CKEC,901,7,5,12,0,0,0,0,0,0,0,0,0,0,0,0,0,0,0,1,0,1,8,5,13
20172018,87,MONTGOMERY,435,Montgomery County,13,Hillcrest Hall Treatment Center,87435013,210425001867,CKEC,901,10,0,10,0,0,0,0,0,0,0,0,0,0,0,0,0,0,0,1,0,1,11,0,11
20172018,87,MONTGOMERY,435,Montgomery County,12,Hope Hill Children's Home,87435012,210425001866,CKEC,901,0,11,11,0,2,2,0,0,0,0,0,0,0,0,0,0,0,0,0,0,0,0,13,13
20172018,87,MONTGOMERY,435,Montgomery County,30,Mapleton Elementary School,87435030,210425001058,CKEC,901,304,301,605,2,11,13,23,22,45,2,1,3,1,0,1,0,0,0,8,6,14,340,341,681
20172018,87,MONTGOMERY,435,Montgomery County,70,McNabb Middle School,87435070,210425001538,CKEC,901,305,289,594,10,2,12,24,12,36,2,0,2,1,0,1,0,0,0,4,7,11,346,310,656
20172018,87,MONTGOMERY,435,Montgomery County,40,Montgomery County High School,87435040,210425001059,CKEC,901,606,557,1163,12,23,35,34,42,76,3,4,7,0,1,1,0,0,0,6,9,15,661,636,1297
20172018,87,MONTGOMERY,435,Montgomery County,20,Montgomery County Intermediate School,87435020,210425002326,CKEC,901,327,338,665,7,9,16,25,15,40,1,2,3,0,0,0,0,0,0,14,8,22,374,372,746
20172018,87,MONTGOMERY,435,Montgomery County,50,Mount Sterling Elementary School,87435050,210425001060,CKEC,901,259,228,487,9,12,21,27,23,50,0,4,4,1,0,1,0,0,0,9,12,21,305,279,584
20172018,87,MONTGOMERY,435,Montgomery County,25,Northview Elementary,87435025,,CKEC,901,0,0,0,0,0,0,0,0,0,0,0,0,0,0,0,0,0,0,0,0,0,0,0,0
20172018,87,MONTGOMERY,435,Montgomery County,80,The Sterling School,87435080,210425002317,CKEC,901,23,13,36,2,1,3,0,1,1,0,0,0,0,0,0,0,0,0,1,0,1,26,15,41
20172018,87,MONTGOMERY,435,Montgomery County,,---District Total---,,,CKEC,901,2084,1955,4039,43,61,104,142,125,267,10,12,22,3,2,5,0,0,0,47,46,93,2329,2201,4530
20172018,88,MORGAN,441,Morgan County,50,East Valley Elementary School,88441050,210429001549,KEDC,903,65,65,130,2,0,2,0,0,0,0,0,0,0,0,0,0,0,0,0,0,0,67,65,132
20172018,88,MORGAN,441,Morgan County,90,Ezel Elementary School,88441090,210429001066,KEDC,903,71,48,119,0,3,3,1,1,2,0,0,0,0,0,0,0,0,0,0,0,0,72,52,124
20172018,88,MORGAN,441,Morgan County,15,Morgan Central Elementary School,88441015,210429002194,KEDC,903,174,137,311,1,1,2,1,0,1,0,0,0,0,0,0,0,1,1,0,0,0,176,139,315
20172018,88,MORGAN,441,Morgan County,150,Morgan County High School,88441150,210429001068,KEDC,903,321,268,589,1,0,1,1,3,4,0,0,0,2,1,3,0,0,0,0,0,0,325,272,597
20172018,88,MORGAN,441,Morgan County,140,Morgan County Middle School,88441140,210429001067,KEDC,903,231,218,449,1,0,1,2,0,2,0,2,2,0,0,0,0,0,0,0,1,1,234,221,455
20172018,88,MORGAN,441,Morgan County,230,Woodsbend Youth Development Center,88441230,210429001070,KEDC,903,3,0,3,19,0,19,3,0,3,0,0,0,0,0,0,0,0,0,0,0,0,25,0,25
20172018,88,MORGAN,441,Morgan County,18,Wrigley Elementary School,88441018,210429002214,KEDC,903,141,146,287,0,0,0,2,1,3,0,0,0,0,0,0,0,0,0,0,1,1,143,148,291
20172018,88,MORGAN,441,Morgan County,,---District Total---,,,KEDC,903,1006,882,1888,24,4,28,10,5,15,0,2,2,2,1,3,0,1,1,0,2,2,1042,897,1939
20172018,89,MUHLENBERG,445,Muhlenberg County,10,Bremen Elementary School,89445010,210008101072,WKEC,908,176,151,327,0,0,0,4,6,10,0,1,1,0,0,0,0,0,0,5,6,11,185,164,349
20172018,89,MUHLENBERG,445,Muhlenberg County,30,Central City Elementary,89445030,210008101514,WKEC,908,152,146,298,7,3,10,11,7,18,6,0,6,0,0,0,0,0,0,11,9,20,187,165,352
20172018,89,MUHLENBERG,445,Muhlenberg County,40,Greenville Elementary School,89445040,210008101516,WKEC,908,214,216,430,9,8,17,4,3,7,2,0,2,0,0,0,1,0,1,8,10,18,238,237,475
20172018,89,MUHLENBERG,445,Muhlenberg County,115,Longest Elementary,89445115,210008101080,WKEC,908,189,172,361,2,1,3,2,2,4,2,1,3,0,1,1,0,0,0,8,4,12,203,181,384
20172018,89,MUHLENBERG,445,Muhlenberg County,902,Muhlenberg County Career & Tech Center,89445902,210008102139,WKEC,908,0,0,0,0,0,0,0,0,0,0,0,0,0,0,0,0,0,0,0,0,0,0,0,0
20172018,89,MUHLENBERG,445,Muhlenberg County,175,Muhlenberg County High School,89445175,210008102258,WKEC,908,626,559,1185,18,20,38,15,10,25,2,2,4,0,0,0,2,0,2,12,15,27,675,606,1281
20172018,89,MUHLENBERG,445,Muhlenberg County,11,Muhlenberg Job Corps Center,89445011,210008101961,WKEC,908,32,13,45,26,26,52,3,5,8,0,1,1,0,0,0,0,0,0,1,2,3,62,47,109
20172018,89,MUHLENBERG,445,Muhlenberg County,150,Muhlenberg North Middle,89445150,210008101081,WKEC,908,286,264,550,6,4,10,9,10,19,2,1,3,0,0,0,0,0,0,13,8,21,316,287,603
20172018,89,MUHLENBERG,445,Muhlenberg County,12,Muhlenberg South Elementary,89445012,210008101967,WKEC,908,230,202,432,2,2,4,2,2,4,0,1,1,0,1,1,0,0,0,6,8,14,240,216,456
20172018,89,MUHLENBERG,445,Muhlenberg County,45,Muhlenberg South Middle School,89445045,210008101517,WKEC,908,218,208,426,9,5,14,3,6,9,1,0,1,0,0,0,1,0,1,5,7,12,237,226,463
20172018,89,MUHLENBERG,445,Muhlenberg County,35,The Renaissance Center,89445035,210008101515,WKEC,908,40,24,64,2,0,2,0,0,0,0,0,0,0,0,0,0,0,0,4,0,4,46,24,70
20172018,89,MUHLENBERG,445,Muhlenberg County,,---District Total---,,,WKEC,908,2163,1955,4118,81,69,150,53,51,104,15,7,22,0,2,2,4,0,4,73,69,142,2389,2153,4542
20172018,18,CALLOWAY,446,Murray Independent,20,Murray Elementary School,18446020,210438001084,WKEC,908,187,182,369,14,26,40,22,18,40,8,6,14,0,0,0,0,2,2,16,22,38,247,256,503
20172018,18,CALLOWAY,446,Murray Independent,50,Murray High School,18446050,210438001086,WKEC,908,184,191,375,28,13,41,9,15,24,10,11,21,0,0,0,0,0,0,11,10,21,242,240,482
20172018,18,CALLOWAY,446,Murray Independent,30,Murray Middle School,18446030,210438001085,WKEC,908,235,223,458,22,18,40,17,14,31,10,19,29,0,0,0,1,0,1,22,16,38,307,290,597
20172018,18,CALLOWAY,446,Murray Independent,,---District Total---,,,WKEC,908,606,596,1202,64,57,121,48,47,95,28,36,64,0,0,0,1,2,3,49,48,97,796,786,1582
20172018,90,NELSON,451,Nelson County,13,Bloomfield Elementary School,90451013,210441002006,CKEC,901,167,126,293,4,1,5,10,2,12,1,1,2,0,0,0,0,0,0,5,5,10,187,135,322
20172018,90,NELSON,451,Nelson County,10,Bloomfield Middle School,90451010,210441001087,CKEC,901,210,155,365,3,1,4,3,7,10,1,0,1,1,0,1,0,0,0,3,2,5,221,165,386
20172018,90,NELSON,451,Nelson County,30,Boston School,90451030,210441001089,CKEC,901,143,173,316,3,1,4,4,5,9,0,0,0,2,0,2,0,0,0,3,2,5,155,181,336
20172018,90,NELSON,451,Nelson County,50,Coxs Creek Elementary School,90451050,210441001091,CKEC,901,250,206,456,1,1,2,9,5,14,0,0,0,0,0,0,0,0,0,5,3,8,265,215,480
20172018,90,NELSON,451,Nelson County,70,Foster Heights Elementary School,90451070,210441001093,CKEC,901,315,262,577,2,8,10,14,15,29,0,3,3,0,0,0,0,0,0,12,8,20,343,296,639
20172018,90,NELSON,451,Nelson County,100,Nelson County High School,90451100,210441001096,CKEC,901,337,368,705,12,13,25,15,20,35,0,2,2,0,1,1,0,1,1,4,8,12,368,413,781
20172018,90,NELSON,451,Nelson County,90,Old Kentucky Home Middle School,90451090,210441001095,CKEC,901,176,150,326,2,4,6,5,6,11,0,1,1,0,0,0,0,0,0,2,2,4,185,163,348
20172018,90,NELSON,451,Nelson County,19,The Academy at Horizons,90451019,210441002212,CKEC,901,43,26,69,2,0,2,0,0,0,0,0,0,0,0,0,0,1,1,1,0,1,46,27,73
20172018,90,NELSON,451,Nelson County,11,The New Haven School,90451011,210441001937,CKEC,901,188,121,309,3,1,4,3,3,6,0,0,0,0,0,0,0,0,0,0,2,2,194,127,321
20172018,90,NELSON,451,Nelson County,101,Thomas Nelson High School,90451101,210441002324,CKEC,901,305,321,626,2,3,5,7,4,11,2,5,7,1,0,1,1,0,1,3,3,6,321,336,657
20172018,90,NELSON,451,Nelson County,,---District Total---,,,CKEC,901,2134,1908,4042,34,33,67,70,67,137,4,12,16,4,1,5,1,2,3,38,35,73,2285,2058,4343
20172018,19,CAMPBELL,452,Newport Independent,70,Newport High School,19452070,210444001103,NKCES,905,184,158,342,65,50,115,36,35,71,1,0,1,0,0,0,0,0,0,40,41,81,326,284,610
20172018,19,CAMPBELL,452,Newport Independent,40,Newport Intermediate School,19452040,210444001100,NKCES,905,117,156,273,41,36,77,29,32,61,0,0,0,0,1,1,0,0,0,42,32,74,229,257,486
20172018,19,CAMPBELL,452,Newport Independent,20,Newport Primary School,19452020,210444001099,NKCES,905,109,92,201,24,36,60,27,30,57,0,0,0,0,0,0,0,0,0,38,28,66,198,186,384
20172018,19,CAMPBELL,452,Newport Independent,18,Newport Regional School,19452018,210444002401,NKCES,905,3,0,3,5,0,5,1,0,1,0,0,0,0,0,0,0,0,0,1,0,1,10,0,10
20172018,19,CAMPBELL,452,Newport Independent,,---District Total---,,,NKCES,905,413,406,819,135,122,257,93,97,190,1,0,1,0,1,1,0,0,0,121,101,222,763,727,1490
20172018,91,NICHOLAS,455,Nicholas County,20,Nicholas County Elementary School,91455020,210447001106,CKEC,901,259,263,522,2,0,2,9,13,22,1,1,2,0,0,0,0,0,0,3,5,8,274,282,556
20172018,91,NICHOLAS,455,Nicholas County,30,Nicholas County High School,91455030,210447001107,CKEC,901,230,213,443,2,0,2,11,11,22,0,1,1,0,0,0,0,0,0,1,5,6,244,230,474
20172018,91,NICHOLAS,455,Nicholas County,,---District Total---,,,CKEC,901,489,476,965,4,0,4,20,24,44,1,2,3,0,0,0,0,0,0,4,10,14,518,512,1030
20172018,92,OHIO,461,Ohio County,10,Beaver Dam Elementary School,92461010,210450001108,GRREC,902,221,236,457,5,3,8,57,66,123,0,2,2,0,0,0,0,0,0,8,7,15,291,314,605
20172018,92,OHIO,461,Ohio County,90,Fordsville Elementary School,92461090,210450001112,GRREC,902,124,97,221,1,0,1,1,9,10,0,0,0,0,0,0,0,0,0,1,2,3,127,108,235
20172018,92,OHIO,461,Ohio County,140,Horse Branch Elementary School,92461140,210450001115,GRREC,902,107,81,188,0,0,0,3,0,3,0,0,0,0,0,0,0,0,0,0,2,2,110,83,193
20172018,92,OHIO,461,Ohio County,12,Ohio County Alternative Learning Program,92461012,210450002353,GRREC,902,12,10,22,0,0,0,2,0,2,0,0,0,0,0,0,0,0,0,1,0,1,15,10,25
20172018,92,OHIO,461,Ohio County,11,Ohio County Day Treatment,92461011,210450002361,GRREC,902,15,6,21,0,1,1,0,0,0,0,0,0,0,0,0,0,0,0,1,0,1,16,7,23
20172018,92,OHIO,461,Ohio County,155,Ohio County High School,92461155,210450001116,GRREC,902,526,473,999,8,3,11,51,27,78,0,0,0,0,0,0,0,0,0,5,9,14,590,512,1102
20172018,92,OHIO,461,Ohio County,110,Ohio County Middle School,92461110,210450001114,GRREC,902,296,294,590,2,1,3,20,26,46,0,2,2,1,1,2,0,0,0,4,1,5,323,325,648
20172018,92,OHIO,461,Ohio County,170,Southern Elementary School,92461170,210450001118,GRREC,902,140,138,278,0,1,1,5,6,11,0,0,0,0,0,0,0,0,0,2,2,4,147,147,294
20172018,92,OHIO,461,Ohio County,190,Wayland Alexander Elementary School,92461190,210450001119,GRREC,902,312,288,600,1,1,2,17,19,36,1,2,3,0,0,0,0,0,0,8,4,12,339,314,653
20172018,92,OHIO,461,Ohio County,200,Western Elementary School,92461200,210450001120,GRREC,902,137,119,256,1,0,1,5,11,16,0,0,0,0,2,2,0,0,0,4,7,11,147,139,286
20172018,92,OHIO,461,Ohio County,,---District Total---,,,GRREC,902,1890,1742,3632,18,10,28,161,164,325,1,6,7,1,3,4,0,0,0,34,34,68,2105,1959,4064
20172018,93,OLDHAM,465,Oldham County,80,Buckner Alternative High School,93465080,210453000735,OVEC,906,22,17,39,5,4,9,4,1,5,0,0,0,0,0,0,0,0,0,2,1,3,33,23,56
20172018,93,OLDHAM,465,Oldham County,7,Buckner Elementary School,93465007,210453001817,OVEC,906,259,228,487,6,2,8,13,10,23,2,3,5,0,0,0,0,0,0,11,2,13,291,245,536
20172018,93,OLDHAM,465,Oldham County,5,Camden Station Elementary School,93465005,210453001597,OVEC,906,214,214,428,7,9,16,16,14,30,4,4,8,0,0,0,0,0,0,11,12,23,252,253,505
20172018,93,OLDHAM,465,Oldham County,10,Centerfield Elementary School,93465010,210453001121,OVEC,906,232,206,438,3,5,8,21,13,34,2,4,6,0,1,1,0,0,0,15,14,29,273,243,516
20172018,93,OLDHAM,465,Oldham County,20,Crestwood Elementary School,93465020,210453001122,OVEC,906,256,211,467,5,3,8,25,31,56,3,4,7,0,1,1,0,0,0,21,10,31,310,260,570
20172018,93,OLDHAM,465,Oldham County,15,East Oldham Middle School,93465015,210453002009,OVEC,906,319,281,600,6,5,11,15,12,27,8,3,11,1,1,2,0,0,0,13,9,22,362,311,673
20172018,93,OLDHAM,465,Oldham County,25,Goshen At Hillcrest Elementary School,93465025,210453001432,OVEC,906,274,278,552,3,5,8,18,16,34,31,25,56,0,0,0,0,0,0,12,11,23,338,335,673
20172018,93,OLDHAM,465,Oldham County,14,Harmony Elementary School,93465014,210453002008,OVEC,906,306,285,591,5,3,8,9,12,21,6,4,10,1,0,1,1,0,1,9,10,19,337,314,651
20172018,93,OLDHAM,465,Oldham County,13,Kenwood Station Elementary School,93465013,210453002007,OVEC,906,271,309,580,5,9,14,12,9,21,7,5,12,0,0,0,0,0,0,20,12,32,315,344,659
20172018,93,OLDHAM,465,Oldham County,30,LaGrange Elementary School,93465030,210453001123,OVEC,906,158,155,313,7,5,12,50,46,96,1,0,1,0,0,0,0,0,0,14,12,26,230,218,448
20172018,93,OLDHAM,465,Oldham County,28,Locust Grove Elementary School,93465028,210453002196,OVEC,906,331,321,652,10,8,18,22,22,44,8,11,19,2,2,4,1,0,1,13,8,21,387,372,759
20172018,93,OLDHAM,465,Oldham County,12,North Oldham High School,93465012,210453001953,OVEC,906,453,449,902,6,3,9,23,18,41,25,27,52,0,0,0,0,0,0,5,15,20,512,512,1024
20172018,93,OLDHAM,465,Oldham County,350,North Oldham Middle School,93465350,210453001552,OVEC,906,372,352,724,5,8,13,19,17,36,18,18,36,0,1,1,0,0,0,10,9,19,424,405,829
20172018,93,OLDHAM,465,Oldham County,60,Oldham County High School,93465060,210453001125,OVEC,906,711,673,1384,30,22,52,75,54,129,9,11,20,0,1,1,0,0,0,24,27,51,849,788,1637
20172018,93,OLDHAM,465,Oldham County,70,Oldham County Middle School,93465070,210453001126,OVEC,906,319,327,646,9,12,21,42,50,92,2,11,13,0,3,3,0,0,0,10,9,19,382,412,794
20172018,93,OLDHAM,465,Oldham County,95,South Oldham High School,93465095,210453001620,OVEC,906,581,566,1147,23,17,40,21,22,43,20,23,43,1,1,2,0,0,0,19,17,36,665,646,1311
20172018,93,OLDHAM,465,Oldham County,90,South Oldham Middle School,93465090,210453001433,OVEC,906,340,341,681,10,13,23,14,22,36,8,15,23,1,0,1,0,0,0,19,9,28,392,400,792
20172018,93,OLDHAM,465,Oldham County,905,The Robert L. Arvin Education Center,93465905,210453001818,OVEC,906,0,0,0,0,0,0,0,0,0,0,0,0,0,0,0,0,0,0,0,0,0,0,0,0
20172018,93,OLDHAM,465,Oldham County,,---District Total---,,,OVEC,906,5418,5213,10631,145,133,278,399,369,768,154,168,322,6,11,17,2,0,2,228,187,415,6352,6081,12433
20172018,94,OWEN,471,Owen County,78,Maurice Bowling Middle School,94471078,210456001539,OVEC,906,264,292,556,0,0,0,11,17,28,1,4,5,0,0,0,0,0,0,4,5,9,280,318,598
20172018,94,OWEN,471,Owen County,75,Owen County Elementary/Primary School,94471075,210456001127,OVEC,906,312,290,602,2,1,3,17,12,29,0,1,1,0,0,0,0,0,0,7,4,11,338,308,646
20172018,94,OWEN,471,Owen County,80,Owen County High School,94471080,210456001128,OVEC,906,251,274,525,1,2,3,12,11,23,1,0,1,1,0,1,0,0,0,3,2,5,269,289,558
20172018,94,OWEN,471,Owen County,,---District Total---,,,OVEC,906,827,856,1683,3,3,6,40,40,80,2,5,7,1,0,1,0,0,0,14,11,25,887,915,1802
20172018,30,DAVIESS,472,Owensboro Independent,10,Cravens Elementary School,30472010,210459001129,GRREC,902,82,73,155,39,24,63,20,16,36,0,1,1,1,1,2,0,0,0,16,17,33,158,132,290
20172018,30,DAVIESS,472,Owensboro Independent,30,Estes Elementary School,30472030,210459001130,GRREC,902,122,117,239,18,17,35,66,54,120,1,0,1,0,0,0,0,0,0,15,28,43,222,216,438
20172018,30,DAVIESS,472,Owensboro Independent,60,Foust Elementary School,30472060,210459001132,GRREC,902,81,58,139,34,33,67,22,29,51,29,24,53,0,0,0,0,0,0,32,28,60,198,172,370
20172018,30,DAVIESS,472,Owensboro Independent,15,Gateway Academy,30472015,210459002011,GRREC,902,19,10,29,13,7,20,6,1,7,0,0,0,0,0,0,0,0,0,7,0,7,45,18,63
20172018,30,DAVIESS,472,Owensboro Independent,100,Newton Parrish Elementary School,30472100,210459001135,GRREC,902,165,131,296,14,10,24,18,8,26,0,3,3,0,0,0,0,0,0,43,32,75,240,184,424
20172018,30,DAVIESS,472,Owensboro Independent,110,Owensboro High School,30472110,210459001136,GRREC,902,438,381,819,110,86,196,54,48,102,15,25,40,0,0,0,1,1,2,38,60,98,656,601,1257
20172018,30,DAVIESS,472,Owensboro Independent,116,Owensboro Innovation Academy,30472116,210459002411,GRREC,902,0,0,0,0,0,0,0,0,0,0,0,0,0,0,0,0,0,0,0,0,0,0,0,0
20172018,30,DAVIESS,472,Owensboro Independent,108,Owensboro Middle School North,30472108,210459002305,GRREC,902,211,216,427,66,34,100,38,29,67,10,15,25,0,0,0,1,0,1,50,41,91,376,335,711
20172018,30,DAVIESS,472,Owensboro Independent,102,Owensboro Middle School South,30472102,210459002304,GRREC,902,228,222,450,53,59,112,38,39,77,12,10,22,0,1,1,0,0,0,41,47,88,372,378,750
20172018,30,DAVIESS,472,Owensboro Independent,140,Sutton Elementary School,30472140,210459001139,GRREC,902,180,150,330,13,13,26,10,5,15,2,0,2,0,0,0,0,0,0,16,14,30,221,182,403
20172018,30,DAVIESS,472,Owensboro Independent,,---District Total---,,,GRREC,902,1526,1358,2884,360,283,643,272,229,501,69,78,147,1,2,3,2,1,3,258,267,525,2488,2218,4706
20172018,95,OWSLEY,475,Owsley County,20,Owsley County Elementary School,95475020,210462001142,KVEC,904,200,163,363,0,0,0,4,2,6,0,0,0,0,0,0,0,0,0,0,1,1,204,166,370
20172018,95,OWSLEY,475,Owsley County,80,Owsley County High School,95475080,210462001143,KVEC,904,161,148,309,0,1,1,2,0,2,0,0,0,0,0,0,0,0,0,0,0,0,163,149,312
20172018,95,OWSLEY,475,Owsley County,,---District Total---,,,KVEC,904,361,311,672,0,1,1,6,2,8,0,0,0,0,0,0,0,0,0,0,1,1,367,315,682
20172018,79,MCCRACKEN,476,Paducah Independent,16,Choices Educational Center,79476016,210465002364,WKEC,908,9,4,13,24,17,41,0,1,1,0,0,0,0,0,0,0,0,0,7,2,9,40,24,64
20172018,79,MCCRACKEN,476,Paducah Independent,20,Clark Elementary School,79476020,210465001146,WKEC,908,179,162,341,92,82,174,12,17,29,4,3,7,0,0,0,0,0,0,29,32,61,316,296,612
20172018,79,MCCRACKEN,476,Paducah Independent,80,McNabb Elementary School,79476080,210465001150,WKEC,908,43,36,79,118,129,247,13,18,31,0,1,1,0,1,1,0,0,0,31,18,49,205,203,408
20172018,79,MCCRACKEN,476,Paducah Independent,150,Morgan Elementary School,79476150,210465001152,WKEC,908,73,67,140,84,71,155,18,19,37,1,0,1,0,0,0,1,0,1,19,30,49,196,187,383
20172018,79,MCCRACKEN,476,Paducah Independent,10,Paducah Middle School,79476010,210465001144,WKEC,908,133,119,252,126,119,245,29,16,45,0,2,2,0,1,1,0,0,0,35,22,57,323,279,602
20172018,79,MCCRACKEN,476,Paducah Independent,170,Paducah Tilghman High School,79476170,210465001154,WKEC,908,161,178,339,152,159,311,24,21,45,7,3,10,0,0,0,0,0,0,32,27,59,376,388,764
20172018,79,MCCRACKEN,476,Paducah Independent,,---District Total---,,,WKEC,908,598,566,1164,596,577,1173,96,92,188,12,9,21,0,2,2,1,0,1,153,131,284,1456,1377,2833
20172018,58,JOHNSON,477,Paintsville Independent,11,Carl D Perkins Job Corps Academy Alt Sch,58477011,210468001927,KEDC,903,17,3,20,10,5,15,0,0,0,0,0,0,0,0,0,0,0,0,0,0,0,27,8,35
20172018,58,JOHNSON,477,Paintsville Independent,10,Paintsville Elementary School,58477010,210468001155,KEDC,903,194,176,370,0,0,0,2,1,3,5,2,7,0,0,0,0,0,0,0,1,1,201,180,381
20172018,58,JOHNSON,477,Paintsville Independent,20,Paintsville High School,58477020,210468001156,KEDC,903,197,164,361,1,0,1,1,0,1,2,2,4,0,0,0,0,0,0,2,1,3,203,167,370
20172018,58,JOHNSON,477,Paintsville Independent,,---District Total---,,,KEDC,903,408,343,751,11,5,16,3,1,4,7,4,11,0,0,0,0,0,0,2,2,4,431,355,786
20172018,9,BOURBON,478,Paris Independent,10,Paris Elementary School,9478010,210471001157,CKEC,901,76,85,161,23,18,41,22,33,55,0,0,0,1,0,1,0,0,0,29,27,56,151,163,314
20172018,9,BOURBON,478,Paris Independent,20,Paris High School,9478020,210471001158,CKEC,901,55,48,103,29,22,51,15,9,24,1,1,2,0,0,0,0,0,0,9,10,19,109,90,199
20172018,9,BOURBON,478,Paris Independent,30,Paris Middle School,9478030,210471001159,CKEC,901,37,38,75,19,8,27,15,9,24,0,0,0,0,1,1,0,0,0,11,7,18,82,63,145
20172018,9,BOURBON,478,Paris Independent,,---District Total---,,,CKEC,901,168,171,339,71,48,119,52,51,103,1,1,2,1,1,2,0,0,0,49,44,93,342,316,658
20172018,96,PENDLETON,481,Pendleton County,60,Northern Elementary School,96481060,210474001160,NKCES,905,270,186,456,3,4,7,2,2,4,0,1,1,0,0,0,0,0,0,7,7,14,282,200,482
20172018,96,PENDLETON,481,Pendleton County,70,Pendleton County High School,96481070,210474001161,NKCES,905,367,356,723,8,5,13,5,1,6,0,3,3,0,0,0,0,0,0,8,8,16,388,373,761
20172018,96,PENDLETON,481,Pendleton County,61,Phillip Sharp Middle School,96481061,210474001646,NKCES,905,264,236,500,3,5,8,3,1,4,1,3,4,0,0,0,0,0,0,4,5,9,275,250,525
20172018,96,PENDLETON,481,Pendleton County,80,Southern Elementary School,96481080,210474001163,NKCES,905,253,235,488,3,6,9,4,5,9,1,0,1,0,0,0,0,0,0,2,8,10,263,254,517
20172018,96,PENDLETON,481,Pendleton County,,---District Total---,,,NKCES,905,1154,1013,2167,17,20,37,14,9,23,2,7,9,0,0,0,0,0,0,21,28,49,1208,1077,2285
20172018,97,PERRY,485,Perry County,10,Buckhorn Childrens Center,97485010,210477002422,KVEC,904,0,19,19,0,1,1,0,2,2,0,0,0,0,1,1,0,0,0,0,1,1,0,24,24
20172018,97,PERRY,485,Perry County,130,Buckhorn School,97485130,210477001166,KVEC,904,162,163,325,1,3,4,3,4,7,0,0,0,1,0,1,0,0,0,2,1,3,169,171,340
20172018,97,PERRY,485,Perry County,200,East Perry County Elementary School,97485200,210477002354,KVEC,904,357,311,668,3,5,8,7,3,10,1,1,2,0,0,0,0,0,0,7,3,10,375,323,698
20172018,97,PERRY,485,Perry County,140,Learning Academy,97485140,210477002398,KVEC,904,32,17,49,2,1,3,0,0,0,0,0,0,0,0,0,0,0,0,1,0,1,35,18,53
20172018,97,PERRY,485,Perry County,480,Leatherwood Elementary School,97485480,210477001170,KVEC,904,75,83,158,0,0,0,1,0,1,0,1,1,0,0,0,0,0,0,1,0,1,77,84,161
20172018,97,PERRY,485,Perry County,190,Perry County Alternative School,97485190,210477002387,KVEC,904,5,0,5,2,0,2,0,0,0,0,0,0,0,0,0,0,0,0,0,0,0,7,0,7
20172018,97,PERRY,485,Perry County,250,Perry County Central High School,97485250,210477000755,KVEC,904,416,395,811,6,3,9,2,0,2,1,0,1,0,0,0,0,0,0,4,4,8,429,402,831
20172018,97,PERRY,485,Perry County,635,Robert W Combs Elementary School,97485635,210477001174,KVEC,904,215,170,385,0,1,1,1,1,2,0,0,0,0,0,0,0,0,0,0,0,0,216,172,388
20172018,97,PERRY,485,Perry County,640,Robinson Elementary School,97485640,210477001175,KVEC,904,131,116,247,0,0,0,1,1,2,0,0,0,0,0,0,0,0,0,0,0,0,132,117,249
20172018,97,PERRY,485,Perry County,890,Viper Elementary School,97485890,210477001177,KVEC,904,120,111,231,0,2,2,6,4,10,0,0,0,0,0,0,0,0,0,2,0,2,128,117,245
20172018,97,PERRY,485,Perry County,898,West Perry Elementary School,97485898,,KVEC,904,378,371,749,4,5,9,1,6,7,2,2,4,1,0,1,0,2,2,2,4,6,388,390,778
20172018,97,PERRY,485,Perry County,,---District Total---,,,KVEC,904,1891,1756,3647,18,21,39,22,21,43,4,4,8,2,1,3,0,2,2,19,13,32,1956,1818,3774
20172018,98,PIKE,491,Pike County,51,Belfry Elementary,98491051,210480001647,KVEC,904,237,242,479,5,2,7,5,7,12,0,1,1,0,0,0,0,0,0,4,2,6,251,254,505
20172018,98,PIKE,491,Pike County,90,Belfry High School,98491090,210480001179,KVEC,904,311,264,575,9,6,15,0,2,2,2,2,4,0,0,0,0,0,0,3,2,5,325,276,601
20172018,98,PIKE,491,Pike County,58,Belfry Middle School,98491058,210480002013,KVEC,904,203,189,392,4,6,10,1,2,3,1,2,3,0,1,1,0,0,0,6,5,11,215,205,420
20172018,98,PIKE,491,Pike County,130,Bevins Elementary School,98491130,210480001180,KVEC,904,110,88,198,6,2,8,1,3,4,0,0,0,0,0,0,0,0,0,0,0,0,117,93,210
20172018,98,PIKE,491,Pike County,250,Dorton Elementary School,98491250,210480001183,KVEC,904,133,139,272,0,1,1,0,1,1,0,0,0,0,0,0,0,0,0,1,1,2,134,142,276
20172018,98,PIKE,491,Pike County,54,East Ridge High School,98491054,210480001948,KVEC,904,239,233,472,1,0,1,0,0,0,0,0,0,0,0,0,0,0,0,1,0,1,241,233,474
20172018,98,PIKE,491,Pike County,300,Elkhorn City Elementary School,98491300,210480001185,KVEC,904,208,226,434,0,0,0,0,1,1,0,0,0,0,0,0,0,0,0,2,1,3,210,228,438
20172018,98,PIKE,491,Pike County,57,Feds Creek Elementary School,98491057,210480002012,KVEC,904,101,83,184,0,1,1,0,0,0,0,0,0,0,0,0,0,0,0,0,0,0,101,84,185
20172018,98,PIKE,491,Pike County,620,Johns Creek Elementary School,98491620,210480001195,KVEC,904,308,329,637,3,1,4,2,0,2,1,1,2,0,0,0,0,0,0,4,6,10,318,337,655
20172018,98,PIKE,491,Pike County,650,Kimper Elementary School,98491650,210480001197,KVEC,904,67,59,126,0,0,0,1,2,3,0,0,0,0,0,0,0,0,0,3,1,4,71,62,133
20172018,98,PIKE,491,Pike County,59,Millard School,98491059,210480002240,KVEC,904,294,331,625,2,2,4,1,4,5,0,0,0,0,0,0,0,0,0,3,2,5,300,339,639
20172018,98,PIKE,491,Pike County,950,Mullins Elementary School,98491950,210480001202,KVEC,904,381,347,728,3,5,8,6,6,12,7,5,12,0,1,1,0,0,0,9,7,16,406,371,777
20172018,98,PIKE,491,Pike County,10,Northpoint Academy,98491010,210480002256,KVEC,904,33,14,47,0,1,1,0,0,0,0,0,0,0,0,0,0,0,0,0,1,1,33,16,49
20172018,98,PIKE,491,Pike County,952,Phelps Elementary School,98491952,210480001203,KVEC,904,170,196,366,0,0,0,2,2,4,0,0,0,0,0,0,0,0,0,2,0,2,174,198,372
20172018,98,PIKE,491,Pike County,954,Phelps High School,98491954,210480001204,KVEC,904,161,153,314,2,2,4,0,1,1,0,0,0,0,0,0,0,0,0,0,0,0,163,156,319
20172018,98,PIKE,491,Pike County,190,Pike County Central High School,98491190,210480000505,KVEC,904,320,305,625,5,0,5,0,3,3,1,2,3,0,0,0,0,0,0,1,1,2,327,311,638
20172018,98,PIKE,491,Pike County,15,Pike County Day Treatment,98491015,,KVEC,904,17,3,20,1,0,1,0,0,0,0,0,0,0,0,0,0,0,0,1,0,1,19,3,22
20172018,98,PIKE,491,Pike County,980,Shelby Valley High School,98491980,210480001686,KVEC,904,273,266,539,1,0,1,0,4,4,0,0,0,0,0,0,0,0,0,1,2,3,275,272,547
20172018,98,PIKE,491,Pike County,60,Valley Elementary School,98491060,210480002296,KVEC,904,413,424,837,0,3,3,6,4,10,0,0,0,0,0,0,0,0,0,2,1,3,421,432,853
20172018,98,PIKE,491,Pike County,,---District Total---,,,KVEC,904,3979,3891,7870,42,32,74,25,42,67,12,13,25,0,2,2,0,0,0,43,32,75,4101,4012,8113
20172018,98,PIKE,492,Pikeville Independent,20,Pikeville Elementary School,98492020,210483001213,KVEC,904,310,268,578,4,7,11,6,5,11,9,10,19,0,0,0,0,0,0,5,6,11,334,296,630
20172018,98,PIKE,492,Pikeville Independent,30,Pikeville High School,98492030,210483001214,KVEC,904,257,211,468,7,3,10,4,6,10,6,6,12,0,0,0,2,1,3,5,5,10,281,232,513
20172018,98,PIKE,492,Pikeville Independent,,---District Total---,,,KVEC,904,567,479,1046,11,10,21,10,11,21,15,16,31,0,0,0,2,1,3,10,11,21,615,528,1143
20172018,7,BELL,493,Pineville Independent,30,Pineville Independent School,7493030,210486002393,SESC,907,256,256,512,8,2,10,1,2,3,0,0,0,0,0,0,0,0,0,6,4,10,271,264,535
20172018,7,BELL,493,Pineville Independent,,---District Total---,,,SESC,907,256,256,512,8,2,10,1,2,3,0,0,0,0,0,0,0,0,0,6,4,10,271,264,535
20172018,99,POWELL,495,Powell County,10,Bowen Elementary School,99495010,210489001217,CKEC,901,115,94,209,3,0,3,2,4,6,0,0,0,0,0,0,0,0,0,0,0,0,120,98,218
20172018,99,POWELL,495,Powell County,20,Clay City Elementary School,99495020,210489001219,CKEC,901,240,219,459,1,1,2,6,3,9,0,0,0,0,0,0,0,0,0,1,0,1,248,223,471
20172018,99,POWELL,495,Powell County,12,Powell County Academy,99495012,210489002360,CKEC,901,18,3,21,0,0,0,0,0,0,0,0,0,0,0,0,0,0,0,1,0,1,19,3,22
20172018,99,POWELL,495,Powell County,40,Powell County High School,99495040,210489001220,CKEC,901,307,305,612,7,1,8,9,5,14,2,1,3,0,0,0,0,0,0,3,0,3,328,312,640
20172018,99,POWELL,495,Powell County,15,Powell County Middle School,99495015,210489001218,CKEC,901,260,248,508,6,0,6,1,8,9,0,0,0,0,0,0,0,0,0,4,2,6,271,258,529
20172018,99,POWELL,495,Powell County,60,Stanton Elementary School,99495060,210489001221,CKEC,901,174,164,338,2,1,3,4,4,8,0,0,0,0,0,0,0,0,0,3,1,4,183,170,353
20172018,99,POWELL,495,Powell County,,---District Total---,,,CKEC,901,1114,1033,2147,19,3,22,22,24,46,2,1,3,0,0,0,0,0,0,12,3,15,1169,1064,2233
20172018,100,PULASKI,501,Pulaski County,70,Burnside Elementary School,100501070,210495001225,SESC,907,207,197,404,0,0,0,6,5,11,0,0,0,0,0,0,0,0,0,2,6,8,215,208,423
20172018,100,PULASKI,501,Pulaski County,180,Eubank Elementary School,100501180,210495001227,SESC,907,169,144,313,0,2,2,8,7,15,0,0,0,0,0,0,0,0,0,1,2,3,178,155,333
20172018,100,PULASKI,501,Pulaski County,280,Nancy Elementary School,100501280,210495001231,SESC,907,193,159,352,0,0,0,5,2,7,1,1,2,0,0,0,0,0,0,2,0,2,201,162,363
20172018,100,PULASKI,501,Pulaski County,560,Northern Elementary School,100501560,210495001238,SESC,907,220,159,379,2,2,4,8,8,16,0,1,1,0,2,2,1,1,2,2,4,6,233,177,410
20172018,100,PULASKI,501,Pulaski County,395,Northern Middle School,100501395,210495001573,SESC,907,417,395,812,5,0,5,19,15,34,3,1,4,0,0,0,1,2,3,4,4,8,449,417,866
20172018,100,PULASKI,501,Pulaski County,420,Oak Hill Elementary School,100501420,210495000779,SESC,907,233,246,479,4,5,9,10,15,25,4,10,14,1,0,1,0,0,0,10,7,17,262,283,545
20172018,100,PULASKI,501,Pulaski County,380,Pulaski County High School,100501380,210495001233,SESC,907,579,545,1124,3,9,12,23,18,41,4,3,7,0,0,0,0,0,0,6,9,15,615,584,1199
20172018,100,PULASKI,501,Pulaski County,71,Pulaski Day Treatment~Eagle Academy,100501071,210495001554,SESC,907,28,5,33,9,0,9,1,0,1,0,0,0,0,0,0,0,0,0,1,0,1,39,5,44
20172018,100,PULASKI,501,Pulaski County,385,Pulaski Elementary School,100501385,210495001234,SESC,907,290,277,567,0,3,3,14,20,34,1,1,2,1,0,1,0,0,0,10,9,19,316,310,626
20172018,100,PULASKI,501,Pulaski County,440,Shopville Elementary School,100501440,210495001235,SESC,907,146,168,314,0,0,0,7,4,11,0,0,0,1,0,1,1,0,1,1,4,5,156,176,332
20172018,100,PULASKI,501,Pulaski County,570,Southern Elementary School,100501570,210495001464,SESC,907,299,286,585,3,4,7,30,22,52,3,5,8,1,0,1,0,0,0,9,2,11,345,319,664
20172018,100,PULASKI,501,Pulaski County,390,Southern Middle School,100501390,210495001572,SESC,907,480,470,950,7,5,12,24,21,45,6,9,15,1,1,2,0,0,0,4,8,12,522,514,1036
20172018,100,PULASKI,501,Pulaski County,400,Southwestern High School,100501400,210495000506,SESC,907,571,557,1128,10,5,15,21,17,38,7,5,12,0,2,2,1,0,1,6,10,16,616,596,1212
20172018,100,PULASKI,501,Pulaski County,,---District Total---,,,SESC,907,3832,3608,7440,43,35,78,176,154,330,29,36,65,5,5,10,4,3,7,58,65,123,4147,3906,8053
20172018,45,GREENUP,502,Raceland-Worthington Independent,10,Campbell Elementary School,45502010,210498001239,KEDC,903,99,129,228,1,0,1,2,2,4,0,0,0,0,0,0,0,0,0,2,2,4,104,133,237
20172018,45,GREENUP,502,Raceland-Worthington Independent,20,Raceland-Worthington High School,45502020,210498001240,KEDC,903,217,215,432,4,3,7,0,1,1,0,1,1,0,0,0,0,0,0,3,2,5,224,222,446
20172018,45,GREENUP,502,Raceland-Worthington Independent,160,Raceland-Worthington Schools Campus A,45502160,210498001465,KEDC,903,26,7,33,3,0,3,0,0,0,0,0,0,0,0,0,0,0,0,1,0,1,30,7,37
20172018,45,GREENUP,502,Raceland-Worthington Independent,11,Raceland-Worthington Schools Campus B,45502011,210498002015,KEDC,903,8,1,9,3,0,3,0,0,0,0,0,0,0,0,0,0,0,0,1,0,1,12,1,13
20172018,45,GREENUP,502,Raceland-Worthington Independent,30,Worthington Elementary School,45502030,210498001241,KEDC,903,116,100,216,2,2,4,1,3,4,0,0,0,0,0,0,0,0,0,5,1,6,124,106,230
20172018,45,GREENUP,502,Raceland-Worthington Independent,,---District Total---,,,KEDC,903,466,452,918,13,5,18,3,6,9,0,1,1,0,0,0,0,0,0,12,5,17,494,469,963
20172018,101,ROBERTSON,505,Robertson County,10,Robertson County School,101505010,210504001246,KEDC,903,195,174,369,1,0,1,6,1,7,0,1,1,0,0,0,0,0,0,0,1,1,202,177,379
20172018,101,ROBERTSON,505,Robertson County,,---District Total---,,,KEDC,903,195,174,369,1,0,1,6,1,7,0,1,1,0,0,0,0,0,0,0,1,1,202,177,379
20172018,102,ROCKCASTLE,511,Rockcastle County,20,Brodhead Elementary School,102511020,210507001249,SESC,907,167,197,364,0,1,1,2,2,4,1,0,1,0,0,0,0,0,0,3,2,5,173,202,375
20172018,102,ROCKCASTLE,511,Rockcastle County,170,Mt. Vernon Elementary,102511170,210507001251,SESC,907,287,280,567,3,1,4,8,5,13,0,0,0,1,0,1,0,0,0,4,4,8,303,290,593
20172018,102,ROCKCASTLE,511,Rockcastle County,22,Rockcastle Academy for Academic Achievement,102511022,210507001906,SESC,907,13,22,35,0,0,0,0,1,1,0,0,0,0,0,0,0,0,0,0,0,0,13,23,36
20172018,102,ROCKCASTLE,511,Rockcastle County,310,Rockcastle County High School,102511310,210507001252,SESC,907,409,388,797,5,3,8,4,2,6,0,3,3,2,1,3,0,0,0,0,3,3,420,400,820
20172018,102,ROCKCASTLE,511,Rockcastle County,100,Rockcastle County Middle School,102511100,210507000782,SESC,907,289,306,595,3,2,5,4,1,5,1,0,1,0,0,0,0,0,0,2,3,5,299,312,611
20172018,102,ROCKCASTLE,511,Rockcastle County,320,Roundstone Elementary School,102511320,210507001253,SESC,907,114,119,233,0,0,0,2,5,7,0,0,0,0,0,0,0,0,0,2,2,4,118,126,244
20172018,102,ROCKCASTLE,511,Rockcastle County,,---District Total---,,,SESC,907,1279,1312,2591,11,7,18,20,16,36,2,3,5,3,1,4,0,0,0,11,14,25,1326,1353,2679
20172018,103,ROWAN,515,Rowan County,132,Bluegrass Discovery Academy High,103515132,210510002342,KEDC,903,19,1,20,0,0,0,0,0,0,0,0,0,0,0,0,0,0,0,0,0,0,19,1,20
20172018,103,ROWAN,515,Rowan County,133,Bluegrass Discovery Academy Middle,103515133,210510002336,KEDC,903,13,3,16,0,0,0,0,0,0,0,0,0,0,0,0,0,0,0,0,0,0,13,3,16
20172018,103,ROWAN,515,Rowan County,40,Clearfield Elementary School,103515040,210510001254,KEDC,903,168,148,316,0,0,0,3,3,6,0,0,0,0,0,0,0,0,0,1,3,4,172,154,326
20172018,103,ROWAN,515,Rowan County,43,McBrayer Elementary School,103515043,210510002016,KEDC,903,256,249,505,2,2,4,6,8,14,6,1,7,1,1,2,0,0,0,2,9,11,273,270,543
20172018,103,ROWAN,515,Rowan County,130,Morehead Youth Development Center,103515130,210510001258,KEDC,903,0,6,6,0,4,4,0,1,1,0,0,0,0,0,0,0,0,0,0,1,1,0,12,12
20172018,103,ROWAN,515,Rowan County,250,Rodburn Elementary School,103515250,210510000787,KEDC,903,213,175,388,3,1,4,5,8,13,4,0,4,0,0,0,0,0,0,3,4,7,228,188,416
20172018,103,ROWAN,515,Rowan County,210,Rowan County Middle School,103515210,210510001478,KEDC,903,343,330,673,10,5,15,14,11,25,3,8,11,0,1,1,0,0,0,6,7,13,376,362,738
20172018,103,ROWAN,515,Rowan County,180,Rowan County Senior High School,103515180,210510001260,KEDC,903,413,419,832,6,4,10,14,9,23,5,10,15,1,2,3,0,1,1,7,4,11,446,449,895
20172018,103,ROWAN,515,Rowan County,500,Rowan County/MSU Headstart,103515500,,KEDC,903,0,0,0,0,0,0,0,0,0,0,0,0,0,0,0,0,0,0,0,0,0,0,0,0
20172018,103,ROWAN,515,Rowan County,131,Sunrise Children's Services - Morehead,103515131,210510002300,KEDC,903,0,7,7,0,0,0,0,0,0,0,0,0,0,0,0,0,0,0,0,0,0,0,7,7
20172018,103,ROWAN,515,Rowan County,200,Tilden Hogge Elementary School,103515200,210510001261,KEDC,903,104,89,193,2,0,2,2,2,4,0,0,0,0,0,0,0,0,0,2,4,6,110,95,205
20172018,103,ROWAN,515,Rowan County,,---District Total---,,,KEDC,903,1529,1427,2956,23,16,39,44,42,86,18,19,37,2,4,6,0,1,1,21,32,53,1637,1541,3178
20172018,104,RUSSELL,521,Russell County,140,Jamestown Elementary School,104521140,210516001263,GRREC,902,209,188,397,0,0,0,22,21,43,4,3,7,0,0,0,0,0,0,7,5,12,242,217,459
20172018,104,RUSSELL,521,Russell County,240,Russell County High School,104521240,210516001265,GRREC,902,413,388,801,8,3,11,20,18,38,1,2,3,1,0,1,1,1,2,1,0,1,445,412,857
20172018,104,RUSSELL,521,Russell County,260,Russell County Middle School,104521260,210516001599,GRREC,902,298,282,580,4,3,7,28,22,50,4,1,5,0,1,1,0,0,0,8,7,15,342,316,658
20172018,104,RUSSELL,521,Russell County,230,Russell Springs Elementary School,104521230,210516001264,GRREC,902,275,273,548,1,4,5,52,43,95,2,2,4,0,0,0,1,5,6,2,3,5,333,330,663
20172018,104,RUSSELL,521,Russell County,250,Salem Elementary School,104521250,210516001266,GRREC,902,144,133,277,1,0,1,21,22,43,3,0,3,0,1,1,0,0,0,1,3,4,170,159,329
20172018,104,RUSSELL,521,Russell County,,---District Total---,,,GRREC,902,1339,1264,2603,14,10,24,143,126,269,14,8,22,1,2,3,2,6,8,19,18,37,1532,1434,2966
20172018,45,GREENUP,522,Russell Independent,50,Russell High School,45522050,210513001272,KEDC,903,318,281,599,1,1,2,5,1,6,7,6,13,0,0,0,0,0,0,6,7,13,337,296,633
20172018,45,GREENUP,522,Russell Independent,60,Russell Middle School,45522060,210513001273,KEDC,903,246,250,496,2,0,2,1,2,3,2,2,4,0,0,0,0,0,0,10,12,22,261,266,527
20172018,45,GREENUP,522,Russell Independent,11,Russell Primary School,45522011,210513001626,KEDC,903,279,208,487,4,2,6,4,4,8,1,5,6,1,1,2,0,0,0,8,3,11,297,223,520
20172018,45,GREENUP,522,Russell Independent,30,Russell-McDowell Intermediate School,45522030,210513001270,KEDC,903,240,226,466,2,2,4,2,3,5,2,6,8,0,1,1,0,0,0,10,13,23,256,251,507
20172018,45,GREENUP,522,Russell Independent,,---District Total---,,,KEDC,903,1083,965,2048,9,5,14,12,10,22,12,19,31,1,2,3,0,0,0,34,35,69,1151,1036,2187
20172018,71,LOGAN,523,Russellville Independent,25,R E Stevenson Elementary School,71523025,210519001274,GRREC,902,110,103,213,54,36,90,23,24,47,1,4,5,1,0,1,0,0,0,33,36,69,222,203,425
20172018,71,LOGAN,523,Russellville Independent,30,Russellville Junior/Senior High School,71523030,210519001275,GRREC,902,143,144,287,61,65,126,30,18,48,4,3,7,1,0,1,0,0,0,21,33,54,260,263,523
20172018,71,LOGAN,523,Russellville Independent,,---District Total---,,,GRREC,902,253,247,500,115,101,216,53,42,95,5,7,12,2,0,2,0,0,0,54,69,123,482,466,948
20172018,100,PULASKI,524,Science Hill Independent,10,Science Hill Elementary School,100524010,210522001277,SESC,907,185,172,357,0,0,0,9,7,16,1,1,2,0,0,0,0,0,0,1,1,2,196,181,377
20172018,100,PULASKI,524,Science Hill Independent,,---District Total---,,,SESC,907,185,172,357,0,0,0,9,7,16,1,1,2,0,0,0,0,0,0,1,1,2,196,181,377
20172018,105,SCOTT,525,Scott County,12,Anne Mason Elementary School,105525012,210526001942,CKEC,901,214,211,425,36,26,62,23,33,56,5,5,10,1,0,1,1,1,2,24,29,53,304,305,609
20172018,105,SCOTT,525,Scott County,10,Eastern Elementary School,105525010,210526001278,CKEC,901,204,194,398,14,10,24,33,30,63,8,5,13,0,0,0,0,1,1,19,6,25,278,246,524
20172018,105,SCOTT,525,Scott County,44,Elkhorn Crossing School,105525044,210526002301,CKEC,901,0,0,0,0,0,0,0,0,0,0,0,0,0,0,0,0,0,0,0,0,0,0,0,0
20172018,105,SCOTT,525,Scott County,15,Garth Elementary School,105525015,210526001279,CKEC,901,179,162,341,19,9,28,20,15,35,2,1,3,0,0,0,0,2,2,14,10,24,234,199,433
20172018,105,SCOTT,525,Scott County,18,Georgetown Middle School,105525018,210526001280,CKEC,901,162,151,313,38,26,64,19,31,50,0,2,2,2,3,5,0,0,0,13,18,31,234,231,465
20172018,105,SCOTT,525,Scott County,14,Lemons Mill Elementary School,105525014,210526002349,CKEC,901,286,275,561,18,25,43,46,46,92,1,0,1,0,0,0,0,3,3,18,15,33,369,364,733
20172018,105,SCOTT,525,Scott County,35,Northern Elementary School,105525035,210526001687,CKEC,901,196,190,386,1,1,2,4,4,8,1,0,1,0,0,0,0,1,1,5,7,12,207,203,410
20172018,105,SCOTT,525,Scott County,5,Phoenix Horizon Community,105525005,,CKEC,901,39,26,65,2,9,11,3,3,6,0,0,0,0,1,1,0,0,0,1,2,3,45,41,86
20172018,105,SCOTT,525,Scott County,13,Royal Spring Middle School,105525013,210526002017,CKEC,901,338,362,700,24,35,59,46,40,86,5,11,16,0,0,0,2,2,4,14,17,31,429,467,896
20172018,105,SCOTT,525,Scott County,40,Scott County High School,105525040,210526001283,CKEC,901,685,745,1430,59,52,111,51,68,119,9,13,22,0,0,0,0,1,1,17,20,37,821,899,1720
20172018,105,SCOTT,525,Scott County,60,Scott County Middle School,105525060,210526001285,CKEC,901,357,326,683,5,5,10,37,34,71,1,3,4,0,0,0,0,0,0,7,12,19,407,380,787
20172018,105,SCOTT,525,Scott County,45,Scott County Ninth Grade School,105525045,210526001557,CKEC,901,281,256,537,18,26,44,26,32,58,2,3,5,0,0,0,0,0,0,13,7,20,340,324,664
20172018,105,SCOTT,525,Scott County,70,Southern Elementary School,105525070,210526001286,CKEC,901,202,213,415,41,25,66,23,24,47,3,1,4,0,0,0,0,0,0,17,17,34,286,280,566
20172018,105,SCOTT,525,Scott County,50,Stamping Ground Elementary School,105525050,210526001284,CKEC,901,171,185,356,4,3,7,17,16,33,1,0,1,0,0,0,0,0,0,8,6,14,201,210,411
20172018,105,SCOTT,525,Scott County,80,Western Elementary School,105525080,210526000530,CKEC,901,240,247,487,4,4,8,56,52,108,3,4,7,0,0,0,1,0,1,7,7,14,311,314,625
20172018,105,SCOTT,525,Scott County,,---District Total---,,,CKEC,901,3554,3543,7097,283,256,539,404,428,832,41,48,89,3,4,7,4,11,15,177,173,350,4466,4463,8929
20172018,106,SHELBY,531,Shelby County,120,Clear Creek Elementary,106531120,210532001295,OVEC,906,195,195,390,29,25,54,51,57,108,2,3,5,1,1,2,0,0,0,15,11,26,293,292,585
20172018,106,SHELBY,531,Shelby County,65,Heritage Elementary,106531065,210532001688,OVEC,906,228,191,419,10,5,15,24,15,39,1,0,1,1,0,1,0,0,0,5,9,14,269,220,489
20172018,106,SHELBY,531,Shelby County,40,Martha Layne Collins High School,106531040,210532002253,OVEC,906,403,397,800,70,39,109,119,96,215,5,6,11,2,1,3,0,1,1,23,20,43,622,560,1182
20172018,106,SHELBY,531,Shelby County,14,Painted Stone Elementary,106531014,210532001964,OVEC,906,167,147,314,17,10,27,79,88,167,0,0,0,0,0,0,0,0,0,17,7,24,280,252,532
20172018,106,SHELBY,531,Shelby County,170,Shelby Co Education Center,106531170,210532001690,OVEC,906,6,7,13,2,0,2,2,0,2,0,0,0,0,0,0,0,0,0,2,0,2,12,7,19
20172018,106,SHELBY,531,Shelby County,110,Shelby County East Middle School,106531110,210532001294,OVEC,906,239,234,473,25,29,54,78,77,155,2,3,5,1,0,1,0,0,0,19,13,32,364,356,720
20172018,106,SHELBY,531,Shelby County,90,Shelby County High School,106531090,210532001292,OVEC,906,364,345,709,36,34,70,98,82,180,6,3,9,2,4,6,1,0,1,8,18,26,515,486,1001
20172018,106,SHELBY,531,Shelby County,80,Shelby County West Middle School,106531080,210532001291,OVEC,906,290,254,544,29,22,51,83,78,161,6,10,16,2,0,2,0,0,0,17,25,42,427,389,816
20172018,106,SHELBY,531,Shelby County,100,Simpsonville Elementary,106531100,210532001293,OVEC,906,194,191,385,18,14,32,54,41,95,2,2,4,0,0,0,0,0,0,16,11,27,284,259,543
20172018,106,SHELBY,531,Shelby County,15,Southside Elementary,106531015,210532002077,OVEC,906,140,121,261,15,17,32,71,66,137,2,3,5,0,0,0,0,0,0,19,16,35,247,223,470
20172018,106,SHELBY,531,Shelby County,130,Wright Elementary,106531130,210532001434,OVEC,906,122,141,263,22,18,40,76,60,136,0,0,0,0,0,0,1,1,2,22,16,38,243,236,479
20172018,106,SHELBY,531,Shelby County,,---District Total---,,,OVEC,906,2348,2223,4571,273,213,486,735,660,1395,26,30,56,9,6,15,2,2,4,163,146,309,3556,3280,6836
20172018,19,CAMPBELL,533,Silver Grove Independent,12,Silver Grove School,19533012,210537001727,NKCES,905,83,70,153,1,1,2,2,3,5,0,0,0,0,0,0,0,0,0,2,1,3,88,75,163
20172018,19,CAMPBELL,533,Silver Grove Independent,,---District Total---,,,NKCES,905,83,70,153,1,1,2,2,3,5,0,0,0,0,0,0,0,0,0,2,1,3,88,75,163
20172018,107,SIMPSON,535,Simpson County,20,Franklin Elementary School,107535020,210540001299,GRREC,902,84,81,165,13,4,17,8,4,12,1,0,1,0,0,0,0,0,0,6,12,18,112,101,213
20172018,107,SIMPSON,535,Simpson County,40,Franklin-Simpson High School,107535040,210540001301,GRREC,902,349,322,671,52,54,106,19,17,36,3,3,6,1,1,2,0,0,0,10,12,22,434,409,843
20172018,107,SIMPSON,535,Simpson County,7,Franklin-Simpson High School West Campus,107535007,210540001652,GRREC,902,31,22,53,8,4,12,1,1,2,0,0,0,0,0,0,1,0,1,4,2,6,45,29,74
20172018,107,SIMPSON,535,Simpson County,30,Franklin-Simpson Middle School,107535030,210540001300,GRREC,902,238,252,490,31,32,63,24,18,42,3,4,7,2,1,3,0,0,0,22,14,36,320,321,641
20172018,107,SIMPSON,535,Simpson County,45,Lincoln Elementary School,107535045,210540001302,GRREC,902,189,166,355,25,26,51,12,12,24,2,3,5,0,0,0,0,1,1,11,14,25,239,222,461
20172018,107,SIMPSON,535,Simpson County,100,Simpson Elementary School,107535100,210540001435,GRREC,902,263,246,509,39,22,61,16,9,25,6,2,8,0,0,0,0,0,0,27,22,49,351,301,652
20172018,107,SIMPSON,535,Simpson County,,---District Total---,,,GRREC,902,1154,1089,2243,168,142,310,80,61,141,15,12,27,3,2,5,1,1,2,80,76,156,1501,1383,2884
20172018,100,PULASKI,536,Somerset Independent,50,Hopkins Elementary School,100536050,210543001307,SESC,907,252,227,479,10,5,15,33,25,58,6,4,10,1,0,1,0,0,0,12,19,31,314,280,594
20172018,100,PULASKI,536,Somerset Independent,90,Meece Middle School,100536090,210543001311,SESC,907,193,198,391,5,7,12,24,27,51,7,4,11,0,0,0,0,0,0,8,11,19,237,247,484
20172018,100,PULASKI,536,Somerset Independent,70,Somerset High School,100536070,210543001310,SESC,907,249,203,452,11,13,24,19,13,32,11,6,17,0,1,1,0,0,0,7,3,10,297,239,536
20172018,100,PULASKI,536,Somerset Independent,,---District Total---,,,SESC,907,694,628,1322,26,25,51,76,65,141,24,14,38,1,1,2,0,0,0,27,33,60,848,766,1614
20172018,19,CAMPBELL,537,Southgate Independent,10,Southgate Public School,19537010,210546001313,NKCES,905,47,55,102,13,21,34,5,3,8,0,1,1,0,0,0,0,0,0,11,18,29,76,98,174
20172018,19,CAMPBELL,537,Southgate Independent,,---District Total---,,,NKCES,905,47,55,102,13,21,34,5,3,8,0,1,1,0,0,0,0,0,0,11,18,29,76,98,174
20172018,108,SPENCER,541,Spencer County,42,Hillview Academy,108541042,210549002051,OVEC,906,23,11,34,0,0,0,1,0,1,0,0,0,0,0,0,0,0,0,1,0,1,25,11,36
20172018,108,SPENCER,541,Spencer County,40,Spencer County Elementary School,108541040,210549001314,OVEC,906,316,282,598,5,4,9,9,11,20,3,2,5,1,0,1,0,0,0,21,10,31,355,309,664
20172018,108,SPENCER,541,Spencer County,50,Spencer County High School,108541050,210549001315,OVEC,906,424,389,813,9,3,12,18,17,35,2,2,4,1,2,3,0,0,0,14,14,28,468,427,895
20172018,108,SPENCER,541,Spencer County,41,Spencer County Middle School,108541041,210549001871,OVEC,906,347,294,641,2,2,4,18,13,31,0,4,4,1,0,1,0,0,0,15,9,24,383,322,705
20172018,108,SPENCER,541,Spencer County,44,Taylorsville Elementary School,108541044,210549002018,OVEC,906,282,256,538,1,2,3,8,12,20,0,0,0,0,0,0,0,0,0,8,17,25,299,287,586
20172018,108,SPENCER,541,Spencer County,,---District Total---,,,OVEC,906,1392,1232,2624,17,11,28,54,53,107,5,8,13,3,2,5,0,0,0,59,50,109,1530,1356,2886
20172018,109,TAYLOR,545,Taylor County,20,Taylor County Elementary School,109545020,210552001317,GRREC,902,273,249,522,7,7,14,10,10,20,6,3,9,0,0,0,1,0,1,14,14,28,311,283,594
20172018,109,TAYLOR,545,Taylor County,30,Taylor County High School,109545030,210552001318,GRREC,902,378,377,755,13,6,19,11,10,21,3,4,7,0,0,0,0,1,1,6,9,15,411,407,818
20172018,109,TAYLOR,545,Taylor County,40,Taylor County Middle School,109545040,210552001319,GRREC,902,294,276,570,5,6,11,8,13,21,0,8,8,0,0,0,1,0,1,15,8,23,323,311,634
20172018,109,TAYLOR,545,Taylor County,5,Taylor County Primary Center,109545005,,GRREC,902,247,223,470,3,4,7,9,10,19,2,3,5,0,1,1,1,0,1,13,13,26,275,254,529
20172018,109,TAYLOR,545,Taylor County,,---District Total---,,,GRREC,902,1192,1125,2317,28,23,51,38,43,81,11,18,29,0,1,1,3,1,4,48,44,92,1320,1255,2575
20172018,110,TODD,551,Todd County,17,Horizons High School,110551017,210555002034,GRREC,902,20,3,23,5,1,6,2,1,3,0,0,0,0,0,0,0,0,0,2,0,2,29,5,34
20172018,110,TODD,551,Todd County,5,North Todd Elementary School,110551005,210555001600,GRREC,902,165,166,331,4,2,6,9,6,15,0,0,0,0,0,0,0,1,1,7,4,11,185,179,364
20172018,110,TODD,551,Todd County,15,South Todd Elementary School,110551015,210555001601,GRREC,902,151,153,304,34,37,71,35,20,55,2,0,2,1,1,2,0,0,0,11,17,28,234,228,462
20172018,110,TODD,551,Todd County,95,Todd County Central High School,110551095,210555001325,GRREC,902,222,207,429,22,25,47,13,16,29,0,0,0,0,0,0,0,0,0,4,8,12,261,256,517
20172018,110,TODD,551,Todd County,80,Todd County Middle School,110551080,210555001324,GRREC,902,169,178,347,25,22,47,24,30,54,0,0,0,1,0,1,0,0,0,11,8,19,230,238,468
20172018,110,TODD,551,Todd County,,---District Total---,,,GRREC,902,727,707,1434,90,87,177,83,73,156,2,0,2,2,1,3,0,1,1,35,37,72,939,906,1845
20172018,111,TRIGG,555,Trigg County,70,Trigg County High School,111555070,210558001329,WKEC,908,259,237,496,35,21,56,10,8,18,0,0,0,0,2,2,0,0,0,12,15,27,316,283,599
20172018,111,TRIGG,555,Trigg County,14,Trigg County Intermediate School,111555014,210558002167,WKEC,908,176,200,376,16,15,31,6,4,10,3,1,4,0,1,1,0,0,0,14,18,32,215,239,454
20172018,111,TRIGG,555,Trigg County,50,Trigg County Middle School,111555050,210558001328,WKEC,908,206,182,388,18,22,40,5,7,12,1,2,3,0,0,0,0,0,0,11,23,34,241,236,477
20172018,111,TRIGG,555,Trigg County,13,Trigg County Primary School,111555013,210558002093,WKEC,908,188,162,350,17,17,34,10,5,15,0,1,1,0,0,0,0,0,0,15,19,34,230,204,434
20172018,111,TRIGG,555,Trigg County,,---District Total---,,,WKEC,908,829,781,1610,86,75,161,31,24,55,4,4,8,0,3,3,0,0,0,52,75,127,1002,962,1964
20172018,112,TRIMBLE,561,Trimble County,10,Bedford Elementary School,112561010,210561001330,OVEC,906,190,165,355,0,0,0,10,3,13,0,1,1,0,0,0,2,0,2,2,2,4,204,171,375
20172018,112,TRIMBLE,561,Trimble County,20,Milton Elementary School,112561020,210561001332,OVEC,906,117,130,247,1,0,1,3,3,6,0,0,0,0,0,0,0,0,0,0,1,1,121,134,255
20172018,112,TRIMBLE,561,Trimble County,35,Trimble County Alternative Program,112561035,,OVEC,906,0,0,0,0,0,0,0,0,0,0,0,0,0,0,0,0,0,0,0,0,0,0,0,0
20172018,112,TRIMBLE,561,Trimble County,30,Trimble County High School,112561030,210561001333,OVEC,906,172,163,335,1,1,2,2,5,7,1,3,4,1,0,1,0,1,1,2,1,3,179,174,353
20172018,112,TRIMBLE,561,Trimble County,15,Trimble County Middle School,112561015,210561001331,OVEC,906,95,96,191,1,0,1,0,2,2,1,1,2,0,0,0,0,1,1,1,1,2,98,101,199
20172018,112,TRIMBLE,561,Trimble County,,---District Total---,,,OVEC,906,574,554,1128,3,1,4,15,13,28,2,5,7,1,0,1,2,2,4,5,5,10,602,580,1182
20172018,113,UNION,565,Union County,23,Clements Victory Technical HS #2,113565023,210564001908,WKEC,908,3,1,4,10,1,11,3,1,4,0,0,0,0,0,0,0,0,0,0,0,0,16,3,19
20172018,113,UNION,565,Union County,22,Earle C Clements Job Corps Center,113565022,210564001907,WKEC,908,2,1,3,7,0,7,0,0,0,0,0,0,0,0,0,0,0,0,0,0,0,9,1,10
20172018,113,UNION,565,Union County,20,Morganfield Elementary School,113565020,210564001334,WKEC,908,158,123,281,22,17,39,8,4,12,0,0,0,0,0,0,0,0,0,16,16,32,204,160,364
20172018,113,UNION,565,Union County,50,Sturgis Elementary School,113565050,210564001336,WKEC,908,181,180,361,2,5,7,1,0,1,0,1,1,0,0,0,0,0,0,6,8,14,190,194,384
20172018,113,UNION,565,Union County,902,Union County Area Vocational Ed Center,113565902,210564002175,WKEC,908,0,0,0,0,0,0,0,0,0,0,0,0,0,0,0,0,0,0,0,0,0,0,0,0
20172018,113,UNION,565,Union County,65,Union County High School,113565065,210564001338,WKEC,908,289,290,579,36,36,72,2,2,4,3,2,5,0,0,0,0,0,0,7,12,19,337,342,679
20172018,113,UNION,565,Union County,21,Union County Learning Academy,113565021,210564001872,WKEC,908,6,4,10,1,1,2,0,0,0,0,0,0,0,0,0,0,0,0,1,0,1,8,5,13
20172018,113,UNION,565,Union County,55,Union County Middle School,113565055,210564001602,WKEC,908,180,201,381,14,16,30,1,5,6,1,0,1,0,0,0,0,0,0,10,16,26,206,238,444
20172018,113,UNION,565,Union County,70,Uniontown Elementary School,113565070,210564001339,WKEC,908,91,73,164,2,2,4,1,0,1,1,1,2,0,1,1,0,0,0,10,3,13,105,80,185
20172018,113,UNION,565,Union County,,---District Total---,,,WKEC,908,910,873,1783,94,78,172,16,12,28,5,4,9,0,1,1,0,0,0,50,55,105,1075,1023,2098
20172018,8,BOONE,567,Walton-Verona Independent,10,Walton-Verona Elementary School,8567010,210570001341,NKCES,905,261,288,549,3,2,5,3,5,8,0,3,3,0,0,0,0,0,0,9,7,16,276,305,581
20172018,8,BOONE,567,Walton-Verona Independent,20,Walton-Verona High School,8567020,210570001342,NKCES,905,258,252,510,4,3,7,3,3,6,3,4,7,0,0,0,1,1,2,5,2,7,274,265,539
20172018,8,BOONE,567,Walton-Verona Independent,15,Walton-Verona Middle School,8567015,210570002191,NKCES,905,265,242,507,4,2,6,4,3,7,3,5,8,0,0,0,0,0,0,7,8,15,283,260,543
20172018,8,BOONE,567,Walton-Verona Independent,,---District Total---,,,NKCES,905,784,782,1566,11,7,18,10,11,21,6,12,18,0,0,0,1,1,2,21,17,38,833,830,1663
20172018,114,WARREN,571,Warren County,10,Alvaton Elementary,114571010,210573001343,GRREC,902,256,224,480,14,15,29,25,23,48,45,37,82,0,2,2,5,4,9,15,20,35,360,325,685
20172018,114,WARREN,571,Warren County,20,Beacon Academy,114571020,210573002410,GRREC,902,17,36,53,0,3,3,1,0,1,0,0,0,0,0,0,0,0,0,2,3,5,20,42,62
20172018,114,WARREN,571,Warren County,15,Briarwood Elementary School,114571015,210573001909,GRREC,902,224,216,440,23,24,47,27,26,53,78,84,162,0,1,1,1,6,7,12,16,28,365,373,738
20172018,114,WARREN,571,Warren County,40,Bristow Elementary,114571040,210573001344,GRREC,902,187,204,391,48,41,89,51,39,90,6,3,9,0,0,0,0,0,0,32,26,58,324,313,637
20172018,114,WARREN,571,Warren County,1,Carol Martin Gatton Academy of Math & Science,114571001,,GRREC,902,0,0,0,0,0,0,0,0,0,0,0,0,0,0,0,0,0,0,0,0,0,0,0,0
20172018,114,WARREN,571,Warren County,70,Cumberland Trace Elementary,114571070,210573001346,GRREC,902,195,197,392,15,14,29,33,22,55,16,21,37,0,0,0,6,7,13,17,11,28,282,272,554
20172018,114,WARREN,571,Warren County,75,Drakes Creek Middle School,114571075,210573001603,GRREC,902,225,216,441,14,17,31,17,19,36,48,46,94,0,0,0,2,3,5,14,11,25,320,312,632
20172018,114,WARREN,571,Warren County,245,GEO International High School,114571245,,GRREC,902,8,2,10,32,20,52,20,25,45,27,42,69,0,0,0,0,0,0,0,0,0,87,89,176
20172018,114,WARREN,571,Warren County,230,Greenwood High School,114571230,210573001692,GRREC,902,418,437,855,28,26,54,49,32,81,86,82,168,0,0,0,9,5,14,20,15,35,610,597,1207
20172018,114,WARREN,571,Warren County,175,Henry F. Moss Middle School,114571175,210573001604,GRREC,902,138,120,258,52,52,104,62,33,95,38,21,59,0,0,0,2,1,3,11,12,23,303,239,542
20172018,114,WARREN,571,Warren County,250,Jackson Academy High School,114571250,210573002302,GRREC,902,7,1,8,1,1,2,1,0,1,1,0,1,0,0,0,0,0,0,2,0,2,12,2,14
20172018,114,WARREN,571,Warren County,12,Jackson Academy Middle School,114571012,210573001831,GRREC,902,2,2,4,1,0,1,1,0,1,0,0,0,0,0,0,0,0,0,0,0,0,4,2,6
20172018,114,WARREN,571,Warren County,25,Jennings Creek Elementary,114571025,,GRREC,902,0,0,0,0,0,0,0,0,0,0,0,0,0,0,0,0,0,0,0,0,0,0,0,0
20172018,114,WARREN,571,Warren County,30,Jody Richards Elementary,114571030,210573002327,GRREC,902,277,277,554,15,13,28,33,21,54,27,31,58,0,0,0,1,0,1,10,10,20,363,352,715
20172018,114,WARREN,571,Warren County,16,Lighthouse Academy,114571016,210573001926,GRREC,902,3,2,5,3,1,4,1,0,1,0,0,0,0,0,0,0,0,0,0,0,0,7,3,10
20172018,114,WARREN,571,Warren County,80,Lost River Elementary,114571080,210573001164,GRREC,902,178,175,353,73,69,142,63,63,126,63,45,108,0,0,0,3,5,8,19,23,42,399,380,779
20172018,114,WARREN,571,Warren County,110,North Warren Elementary,114571110,210573001347,GRREC,902,161,156,317,11,10,21,5,10,15,2,0,2,0,2,2,1,0,1,10,11,21,190,189,379
20172018,114,WARREN,571,Warren County,130,Oakland Elementary,114571130,210573001348,GRREC,902,91,77,168,25,25,50,26,15,41,1,2,3,2,0,2,1,2,3,13,9,22,159,130,289
20172018,114,WARREN,571,Warren County,18,Plano Elementary,114571018,210573002035,GRREC,902,242,202,444,7,6,13,12,15,27,3,7,10,1,0,1,2,1,3,11,7,18,278,238,516
20172018,114,WARREN,571,Warren County,140,Rich Pond Elementary,114571140,210573001349,GRREC,902,248,246,494,4,6,10,13,11,24,18,14,32,0,1,1,0,0,0,13,7,20,296,285,581
20172018,114,WARREN,571,Warren County,150,Richardsville Elementary,114571150,210573001350,GRREC,902,191,167,358,3,3,6,8,14,22,0,0,0,0,0,0,0,0,0,2,3,5,204,187,391
20172018,114,WARREN,571,Warren County,300,Rivendell Elementary,114571300,210573000828,GRREC,902,22,6,28,5,0,5,1,0,1,0,0,0,0,0,0,0,0,0,0,0,0,28,6,34
20172018,114,WARREN,571,Warren County,305,Rivendell High School,114571305,210573000839,GRREC,902,18,7,25,1,1,2,0,0,0,0,0,0,0,0,0,0,0,0,0,0,0,19,8,27
20172018,114,WARREN,571,Warren County,170,Rockfield Elementary,114571170,210573001351,GRREC,902,248,275,523,16,9,25,11,17,28,7,12,19,1,1,2,1,0,1,16,15,31,300,329,629
20172018,114,WARREN,571,Warren County,3,South Warren High School,114571003,210573002277,GRREC,902,462,494,956,30,15,45,33,35,68,30,23,53,0,0,0,0,0,0,13,24,37,568,591,1159
20172018,114,WARREN,571,Warren County,2,South Warren Middle School,114571002,210573002298,GRREC,902,306,281,587,12,15,27,12,18,30,16,16,32,0,0,0,1,0,1,9,5,14,356,335,691
20172018,114,WARREN,571,Warren County,750,WKU Child Care Consortium/Headstart,114571750,,GRREC,902,0,0,0,0,0,0,0,0,0,0,0,0,0,0,0,0,0,0,0,0,0,0,0,0
20172018,114,WARREN,571,Warren County,210,Warren Central High School,114571210,210573001353,GRREC,902,230,223,453,74,95,169,75,68,143,36,34,70,0,0,0,0,2,2,27,23,50,442,445,887
20172018,114,WARREN,571,Warren County,455,Warren County Day Treatment,114571455,210573001540,GRREC,902,9,1,10,6,0,6,2,2,4,0,0,0,0,0,0,0,0,0,2,1,3,19,4,23
20172018,114,WARREN,571,Warren County,220,Warren East High School,114571220,210573001354,GRREC,902,329,330,659,41,38,79,32,26,58,4,7,11,0,1,1,1,1,2,12,14,26,419,417,836
20172018,114,WARREN,571,Warren County,205,Warren East Middle School,114571205,210573001605,GRREC,902,178,192,370,21,18,39,27,14,41,3,0,3,3,1,4,0,1,1,13,14,27,245,240,485
20172018,114,WARREN,571,Warren County,200,Warren Elementary,114571200,210573001352,GRREC,902,123,128,251,115,108,223,83,78,161,34,24,58,1,0,1,1,2,3,21,28,49,378,368,746
20172018,114,WARREN,571,Warren County,100,William H. Natcher Elementary,114571100,210573001691,GRREC,902,170,185,355,22,40,62,38,42,80,61,74,135,1,0,1,4,1,5,14,19,33,310,361,671
20172018,114,WARREN,571,Warren County,,---District Total---,,,GRREC,902,5163,5079,10242,712,685,1397,762,668,1430,650,625,1275,9,9,18,41,41,82,330,327,657,7667,7434,15101
20172018,115,WASHINGTON,575,Washington County,21,Commander Academy,115575021,210576002358,CKEC,901,22,12,34,2,1,3,4,1,5,0,0,0,0,0,0,0,0,0,0,0,0,28,14,42
20172018,115,WASHINGTON,575,Washington County,31,North Washington Elementary School,115575031,210576001873,CKEC,901,249,234,483,0,1,1,5,8,13,0,0,0,0,0,0,0,0,0,5,6,11,259,249,508
20172018,115,WASHINGTON,575,Washington County,71,WC Tel Center,115575071,,CKEC,901,0,0,0,0,0,0,0,0,0,0,0,0,0,0,0,0,0,0,0,0,0,0,0,0
20172018,115,WASHINGTON,575,Washington County,80,Washington County Elementary School,115575080,210576001359,CKEC,901,148,111,259,23,17,40,19,30,49,3,1,4,0,1,1,0,0,0,8,6,14,201,166,367
20172018,115,WASHINGTON,575,Washington County,74,Washington County High School,115575074,210576001358,CKEC,901,231,209,440,21,18,39,14,20,34,1,1,2,0,0,0,0,0,0,5,3,8,272,251,523
20172018,115,WASHINGTON,575,Washington County,34,Washington County Middle School,115575034,210576002047,CKEC,901,66,58,124,12,18,30,14,15,29,1,1,2,0,0,0,0,0,0,1,8,9,94,100,194
20172018,115,WASHINGTON,575,Washington County,,---District Total---,,,CKEC,901,716,624,1340,58,55,113,56,74,130,5,3,8,0,1,1,0,0,0,19,23,42,854,780,1634
20172018,116,WAYNE,581,Wayne County,437,Bell Elementary School,116581437,210579001367,SESC,907,174,174,348,0,2,2,24,23,47,0,4,4,0,0,0,0,0,0,4,6,10,202,209,411
20172018,116,WAYNE,581,Wayne County,170,Lake Cumberland Youth Development Center,116581170,210579001361,SESC,907,12,0,12,15,0,15,0,0,0,0,0,0,0,0,0,0,0,0,2,0,2,29,0,29
20172018,116,WAYNE,581,Wayne County,190,Monticello Elementary School,116581190,210579002346,SESC,907,292,298,590,3,5,8,28,34,62,3,2,5,0,0,0,0,1,1,10,4,14,336,344,680
20172018,116,WAYNE,581,Wayne County,180,Otter Creek Academy,116581180,210579002250,SESC,907,0,33,33,0,6,6,0,0,0,0,0,0,0,0,0,0,0,0,0,1,1,0,40,40
20172018,116,WAYNE,581,Wayne County,430,Walker Early Learning Center,116581430,210579001365,SESC,907,104,75,179,1,2,3,12,11,23,0,1,1,0,0,0,0,0,0,2,3,5,119,92,211
20172018,116,WAYNE,581,Wayne County,200,Wayne County High School,116581200,210579001224,SESC,907,440,409,849,6,12,18,25,23,48,2,3,5,0,0,0,0,0,0,3,0,3,476,447,923
20172018,116,WAYNE,581,Wayne County,60,Wayne County Learning Academy,116581060,210579002403,SESC,907,19,3,22,0,0,0,0,0,0,0,0,0,0,0,0,0,0,0,0,0,0,19,3,22
20172018,116,WAYNE,581,Wayne County,51,Wayne County Middle School,116581051,210579002020,SESC,907,327,330,657,8,4,12,26,20,46,1,0,1,0,1,1,0,1,1,0,2,2,362,358,720
20172018,116,WAYNE,581,Wayne County,,---District Total---,,,SESC,907,1368,1322,2690,33,31,64,115,111,226,6,10,16,0,1,1,0,2,2,21,16,37,1543,1493,3036
20172018,117,WEBSTER,585,Webster County,20,Clay Elementary School,117585020,210582001369,WKEC,908,95,117,212,0,0,0,1,4,5,0,0,0,0,0,0,0,0,0,3,4,7,99,125,224
20172018,117,WEBSTER,585,Webster County,50,Dixon Elementary School,117585050,210582001370,WKEC,908,180,165,345,0,1,1,4,5,9,0,0,0,0,0,0,0,1,1,3,4,7,187,176,363
20172018,117,WEBSTER,585,Webster County,60,Providence Elementary School,117585060,210582002188,WKEC,908,108,95,203,9,10,19,9,5,14,0,1,1,0,0,0,0,0,0,10,8,18,136,119,255
20172018,117,WEBSTER,585,Webster County,90,Sebree Elementary School,117585090,210582001372,WKEC,908,89,78,167,1,4,5,81,89,170,0,0,0,0,1,1,0,0,0,1,6,7,172,178,350
20172018,117,WEBSTER,585,Webster County,130,Webster County High School,117585130,210582001374,WKEC,908,248,266,514,9,7,16,48,35,83,1,0,1,0,0,0,2,0,2,9,7,16,317,315,632
20172018,117,WEBSTER,585,Webster County,125,Webster County Middle School,117585125,210582002348,WKEC,908,137,122,259,5,3,8,28,19,47,0,1,1,0,1,1,0,0,0,4,12,16,174,158,332
20172018,117,WEBSTER,585,Webster County,,---District Total---,,,WKEC,908,857,843,1700,24,25,49,171,157,328,1,2,3,0,2,2,2,1,3,30,41,71,1085,1071,2156
20172018,47,HARDIN,586,West Point Independent,10,West Point Elementary School,47586010,210585001375,GRREC,902,47,46,93,0,1,1,0,2,2,1,1,2,0,0,0,0,0,0,3,1,4,51,51,102
20172018,47,HARDIN,586,West Point Independent,,---District Total---,,,GRREC,902,47,46,93,0,1,1,0,2,2,1,1,2,0,0,0,0,0,0,3,1,4,51,51,102
20172018,118,WHITLEY,591,Whitley County,60,Boston Elementary School,118591060,210588001376,SESC,907,96,85,181,0,0,0,2,2,4,0,0,0,0,0,0,0,0,0,1,2,3,99,89,188
20172018,118,WHITLEY,591,Whitley County,290,Oak Grove Elementary School,118591290,210588001381,SESC,907,267,268,535,0,0,0,4,8,12,0,0,0,0,0,0,0,0,0,3,1,4,274,277,551
20172018,118,WHITLEY,591,Whitley County,320,Pleasant View Elementary School,118591320,210588001383,SESC,907,120,124,244,2,0,2,0,0,0,0,0,0,0,0,0,0,0,0,3,1,4,125,125,250
20172018,118,WHITLEY,591,Whitley County,61,Whitley Central Intermediate School,118591061,210588002048,SESC,907,239,203,442,0,0,0,5,1,6,1,1,2,0,0,0,0,0,0,2,1,3,247,206,453
20172018,118,WHITLEY,591,Whitley County,225,Whitley County Alternative School,118591225,210588001262,SESC,907,30,12,42,0,0,0,0,0,0,0,0,0,0,0,0,0,0,0,0,0,0,30,12,42
20172018,118,WHITLEY,591,Whitley County,365,Whitley County Central Primary School,118591365,210588001621,SESC,907,180,187,367,0,2,2,1,1,2,1,0,1,0,0,0,1,0,1,1,0,1,184,190,374
20172018,118,WHITLEY,591,Whitley County,62,Whitley County East Elementary School,118591062,210588002037,SESC,907,113,102,215,0,0,0,1,1,2,0,0,0,0,0,0,0,0,0,2,3,5,116,106,222
20172018,118,WHITLEY,591,Whitley County,430,Whitley County High School,118591430,210588001386,SESC,907,519,518,1037,0,1,1,4,7,11,2,1,3,1,0,1,0,0,0,4,5,9,530,532,1062
20172018,118,WHITLEY,591,Whitley County,435,Whitley County Middle School,118591435,210588001387,SESC,907,268,254,522,0,0,0,2,5,7,4,0,4,0,0,0,0,0,0,2,2,4,276,261,537
20172018,118,WHITLEY,591,Whitley County,350,Whitley County North Elementary School,118591350,210588000546,SESC,907,151,154,305,2,1,3,4,5,9,2,0,2,0,0,0,0,0,0,1,2,3,160,162,322
20172018,118,WHITLEY,591,Whitley County,,---District Total---,,,SESC,907,1983,1907,3890,4,4,8,23,30,53,10,2,12,1,0,1,1,0,1,19,17,36,2041,1960,4001
20172018,118,WHITLEY,592,Williamsburg Independent,12,Williamsburg City School,118592012,210591001939,SESC,907,385,333,718,14,5,19,5,6,11,1,1,2,0,0,0,0,1,1,3,1,4,408,347,755
20172018,118,WHITLEY,592,Williamsburg Independent,,---District Total---,,,SESC,907,385,333,718,14,5,19,5,6,11,1,1,2,0,0,0,0,1,1,3,1,4,408,347,755
20172018,41,GRANT,593,Williamstown Independent,10,Williamstown Elementary,41593010,210594001392,NKCES,905,157,167,324,1,1,2,5,8,13,1,1,2,0,0,0,0,0,0,4,3,7,168,180,348
20172018,41,GRANT,593,Williamstown Independent,20,Williamstown Jr. High,41593020,210594001393,NKCES,905,87,102,189,2,0,2,4,3,7,0,2,2,0,0,0,0,0,0,3,3,6,96,110,206
20172018,41,GRANT,593,Williamstown Independent,30,Williamstown Sr. High,41593030,210594002308,NKCES,905,103,116,219,1,1,2,0,1,1,2,1,3,0,0,0,0,0,0,0,1,1,106,120,226
20172018,41,GRANT,593,Williamstown Independent,,---District Total---,,,NKCES,905,347,385,732,4,2,6,9,12,21,3,4,7,0,0,0,0,0,0,7,7,14,370,410,780
20172018,119,WOLFE,595,Wolfe County,310,Campton Elementary School,119595310,210597001396,KVEC,904,194,153,347,2,1,3,0,1,1,1,1,2,0,0,0,0,0,0,0,0,0,197,156,353
20172018,119,WOLFE,595,Wolfe County,140,Dessie Scott School,119595140,210597002380,KVEC,904,32,0,32,5,0,5,3,0,3,0,0,0,0,0,0,0,0,0,2,0,2,42,0,42
20172018,119,WOLFE,595,Wolfe County,205,Red River Valley Elementary School,119595205,210597001394,KVEC,904,81,56,137,0,1,1,2,2,4,0,0,0,0,0,0,0,0,0,0,0,0,83,59,142
20172018,119,WOLFE,595,Wolfe County,220,Rogers Elementary School,119595220,210597001395,KVEC,904,66,84,150,0,0,0,1,0,1,0,0,0,0,0,0,0,0,0,0,0,0,67,84,151
20172018,119,WOLFE,595,Wolfe County,312,Success Academy,119595312,210597002369,KVEC,904,13,5,18,1,0,1,0,0,0,0,0,0,1,0,1,0,0,0,0,0,0,15,5,20
20172018,119,WOLFE,595,Wolfe County,320,Wolfe County High School,119595320,210597001397,KVEC,904,161,188,349,0,0,0,4,0,4,1,1,2,0,0,0,0,0,0,0,0,0,166,189,355
20172018,119,WOLFE,595,Wolfe County,315,Wolfe County Middle School,119595315,210597001693,KVEC,904,100,95,195,0,0,0,1,2,3,0,0,0,0,0,0,0,0,0,0,0,0,101,97,198
20172018,119,WOLFE,595,Wolfe County,,---District Total---,,,KVEC,904,647,581,1228,8,2,10,11,5,16,2,2,4,1,0,1,0,0,0,2,0,2,671,590,1261
20172018,120,WOODFORD,601,Woodford County,90,Huntertown Elementary School,120601090,210600001468,CKEC,901,151,159,310,7,8,15,21,36,57,1,3,4,0,0,0,0,0,0,7,11,18,187,217,404
20172018,120,WOODFORD,601,Woodford County,120,Northside Elementary School,120601120,210600000320,CKEC,901,120,138,258,6,3,9,26,26,52,0,1,1,0,0,0,0,2,2,10,13,23,162,183,345
20172018,120,WOODFORD,601,Woodford County,13,Safe Harbor Academy,120601013,210600001840,CKEC,901,23,22,45,2,1,3,7,3,10,0,0,0,0,0,0,0,0,0,0,1,1,32,27,59
20172018,120,WOODFORD,601,Woodford County,75,Simmons Elementary School,120601075,210600001403,CKEC,901,98,98,196,20,22,42,57,43,100,1,3,4,0,0,0,0,0,0,12,9,21,188,175,363
20172018,120,WOODFORD,601,Woodford County,50,Southside Elementary School,120601050,210600000284,CKEC,901,237,253,490,0,3,3,30,33,63,1,6,7,0,0,0,1,0,1,15,9,24,284,304,588
20172018,120,WOODFORD,601,Woodford County,84,Woodford County High School,120601084,210600001404,CKEC,901,488,464,952,24,24,48,83,92,175,4,18,22,0,0,0,0,0,0,21,26,47,620,624,1244
20172018,120,WOODFORD,601,Woodford County,85,Woodford County Middle School,120601085,210600001405,CKEC,901,341,344,685,11,13,24,68,72,140,1,8,9,0,1,1,0,0,0,19,25,44,440,463,903
20172018,120,WOODFORD,601,Woodford County,,---District Total---,,,CKEC,901,1458,1478,2936,70,74,144,292,305,597,8,39,47,0,1,1,1,2,3,84,94,178,1913,1993,3906
20172018,56,JEFFERSON,602,Kentucky School for the Blind,176,Kentucky School for the Blind,56602176,210009401779,,909,31,18,49,5,3,8,5,0,5,4,1,5,0,0,0,0,0,0,0,0,0,45,22,67
20172018,56,JEFFERSON,602,Kentucky School for the Blind,,---District Total---,,,,909,31,18,49,5,3,8,5,0,5,4,1,5,0,0,0,0,0,0,0,0,0,45,22,67
20172018,11,BOYLE,603,Kentucky School for the Deaf,390,Kentucky School for the Deaf,11603390,210009501715,CKEC,901,36,32,68,4,4,8,3,1,4,1,3,4,0,0,0,0,0,0,2,1,3,46,41,87
20172018,11,BOYLE,603,Kentucky School for the Deaf,,---District Total---,,,CKEC,901,36,32,68,4,4,8,3,1,4,1,3,4,0,0,0,0,0,0,2,1,3,46,41,87
20172018,,,999,,,---State Total---,,,,,256870,241141,498011,34834,33373,68207,22737,21138,43875,5802,5902,11704,389,407,796,391,417,808,12529,12439,24968,333552,314817,648369